word;score;occurencies;miso;non-miso;PW_pos;PW_neg;#meme
dishwasher;0,341525497;125;121;4;34,27605648;0,029174885;122
chick;0,292967991;40;39;1;44,19061828;0,022629238;67
whore;0,289223098;82;77;5;17,44962876;0,057307809;78
demotivational;0,286599616;138;137;1;155,2337104;0,0064419;261
diy;0,281618475;12;9;3;3,399278329;0,294180089;15
promotion;0,276120905;12;11;1;12,46402054;0,080230933;12
bestdemotivationalposters;0,272875085;120;115;5;26,06113386;0,038371316;120
motivateusnot;0,269428479;10;10;0;inf;0;10
imgur;0,267895551;20;20;0;inf;0;22
motifake;0,259118563;55;55;0;inf;0;54
belong;0,255382552;24;22;2;12,46402054;0,080230933;24
boob;0,240652682;89;87;2;49,28953577;0,020288282;78
ifunny;0,226896662;31;30;1;33,99278329;0,029418009;28
fakeposter;0,224125972;10;10;0;inf;0;10
sammich;0,221346649;11;11;0;inf;0;11
feminist;0,21936691;453;397;56;8,032818432;0,124489307;387
makeup;0,2191241;32;29;3;10,95323017;0,091297269;31
hoe;0,216140267;28;24;4;6,798556658;0,147090044;49
motivation;0,210717699;13;11;2;6,23201027;0,160461867;282
education;0,205999403;12;10;2;5,665463882;0,176508053;14
pussy;0,200374803;46;39;7;6,312945468;0,158404663;47
period;0,196421949;44;36;8;5,098917494;0,196120059;44
tit;0,196311847;60;54;6;10,19783499;0,09806003;351
harpoon;0,195575574;13;10;3;3,776975921;0,26476208;12
istock;0,194692798;15;9;6;1,699639165;0,588360177;5
pole;0,192580884;11;9;2;5,098917494;0,196120059;11
slut;0,191495782;55;48;7;7,769779038;0,128703789;59
leg;0,190774529;25;21;4;5,948737076;0,168102908;173
chloroform;0,18840129;24;22;2;12,46402054;0,080230933;19
maid;0,187864428;11;9;2;5,098917494;0,196120059;12
hillary;0,185872674;12;12;0;inf;0;13
sandwich;0,185740843;146;133;13;11,59241071;0,086263334;142
booty;0,181984324;28;24;4;6,798556658;0,147090044;27
rape;0,179552432;177;155;22;7,983153652;0,12526378;166
cleavage;0,179108964;30;30;0;inf;0;30
quiet;0,179027793;10;8;2;4,532371105;0,220635066;13
marriage;0,177756314;25;20;5;4,532371105;0,220635066;23
women;0,173375958;12;11;1;12,46402054;0,080230933;30
click;0,172782723;11;9;2;5,098917494;0,196120059;8
gap;0,172648235;14;12;2;6,798556658;0,147090044;15
sexism;0,171814698;34;30;4;8,498195823;0,117672035;27
domestic;0,168229691;27;24;3;9,064742211;0,110317533;25
thicc;0,164585455;15;14;1;15,86329887;0,06303859;15
prostitution;0,164537167;11;5;6;0,94424398;1,059048319;7
vagina;0,162520153;39;32;7;5,179852692;0,193055683;43
opinion;0,161745701;19;16;3;6,043161474;0,1654763;18
quickmeme;0,159857396;274;248;26;10,80796187;0,092524383;263
dig;0,158366611;14;14;0;inf;0;134
struggle;0,157862632;19;16;3;6,043161474;0,1654763;15
wave;0,157820229;36;32;4;9,064742211;0,110317533;28
prove;0,156027713;13;10;3;3,776975921;0,26476208;26
blonde;0,155951511;30;26;4;7,365103046;0,135775426;36
beach;0,155680647;17;15;2;8,498195823;0,117672035;17
motivate;0,155554049;31;29;2;16,42984526;0,060864846;52
ferrari;0,154456377;10;9;1;10,19783499;0,09806003;10
herself;0,153827512;20;18;2;10,19783499;0,09806003;17
moon;0,15301267;11;9;2;5,098917494;0,196120059;12
monopoly;0,152461073;10;8;2;4,532371105;0,220635066;11
clinton;0,150854891;15;14;1;15,86329887;0,06303859;16
instagram;0,149000237;43;34;9;4,280572711;0,2336136;41
argument;0,14900007;21;17;4;4,815644299;0,207656533;21
independent;0,148016758;22;19;3;7,17625425;0,139348463;22
ugly;0,146206646;92;75;17;4,998938719;0,20004246;93
titty;0,145569051;14;11;3;4,154673513;0,2406928;13
curvy;0,143945937;13;13;0;inf;0;10
metoo;0,14359811;11;10;1;11,33092776;0,088254027;10
nail;0,142625212;18;11;7;1,780574363;0,561616533;17
equality;0,141255621;48;44;4;12,46402054;0,080230933;46
mgflip;0,140401454;10;8;2;4,532371105;0,220635066;674
feminism;0,139142369;199;161;38;4,800735184;0,208301429;160
girl;0,13857065;790;624;166;4,259336701;0,23477834;1094
icanhascheezburger;0,137611533;10;9;1;10,19783499;0,09806003;10
difference;0,136846189;59;48;11;4,944404842;0,202248811;58
glasses;0,136785403;17;14;3;5,28776629;0,189115771;16
yoga;0,136682281;32;25;7;4,046759916;0,247111274;28
sexist;0,136651776;36;31;5;7,025175213;0,142345204;34
whisper;0,135332122;27;21;6;3,965824717;0,252154362;25
objectify;0,132638904;19;17;2;9,631288599;0,103828267;17
slice;0,13148013;13;10;3;3,776975921;0,26476208;11
logic;0,126973818;28;24;4;6,798556658;0,147090044;34
short;0,126221362;30;24;6;4,532371105;0,220635066;33
whale;0,125818357;15;13;2;7,365103046;0,135775426;15
cream;0,125675841;13;10;3;3,776975921;0,26476208;34
fun;0,124448298;56;43;13;3,74792226;0,266814499;238
section;0,123670569;15;11;4;3,116005135;0,320923733;18
accuse;0,122053012;12;10;2;5,665463882;0,176508053;11
duct;0,121520921;19;17;2;9,631288599;0,103828267;41
woman;0,121037356;1907;1431;476;3,40641967;0,293563359;1571
mouth;0,120791086;30;25;5;5,665463882;0,176508053;32
toe;0,119228943;16;13;3;4,910068698;0,203663138;16
batter;0,118937394;10;10;0;inf;0;10
property;0,118924683;20;16;4;4,532371105;0,220635066;20
drive;0,118388763;69;56;13;4,881015037;0,204875419;117
pic;0,118213117;44;34;10;3,85251544;0,259570666;262
shirt;0,11785716;19;17;2;9,631288599;0,103828267;21
laundry;0,116836606;24;19;5;4,30575255;0,232247438;22
wwiii;0,116730246;11;11;0;inf;0;9
net;0,115361664;279;244;35;7,899275355;0,126593891;404
natural;0,115142147;15;11;4;3,116005135;0,320923733;18
international;0,114925591;22;18;4;5,098917494;0,196120059;21
tan;0,114133434;13;9;4;2,549458747;0,392240118;267
Monday;0,114073466;13;9;4;2,549458747;0,392240118;13
slow;0,113182194;14;11;3;4,154673513;0,2406928;24
sweet;0,112849132;20;14;6;2,643883145;0,378231542;28
memecenter;0,112582069;275;238;37;7,288542724;0,137201638;211
suck;0,112324788;60;47;13;4,096566191;0,244106882;62
ernie;0,111896405;10;7;3;2,643883145;0,378231542;20
tongue;0,111411487;11;8;3;3,021580737;0,3309526;11
wear;0,111354261;86;67;19;3,995642948;0,250272613;86
dress;0,11024858;37;28;9;3,525177526;0,283673657;48
fat;0,108871533;130;105;25;4,758989661;0,210128635;177
bitch;0,107570853;164;126;38;3,757097101;0,266162937;164
duck;0,107069837;12;8;4;2,266185553;0,441270133;12
wisdom;0,104895272;10;8;2;4,532371105;0,220635066;8
issue;0,104352088;21;15;6;2,832731941;0,353016106;23
silly;0,104333984;15;12;3;4,532371105;0,220635066;16
coke;0,104177507;20;14;6;2,643883145;0,378231542;15
doesn;0,103856871;154;85;69;1,395838927;0,716415039;150
body;0,103244009;76;51;25;2,311509264;0,432617777;105
fugly;0,102995389;20;19;1;21,52876275;0,046449488;12
fit;0,102718576;24;17;7;2,751796743;0,363398933;84
lady;0,102205006;67;49;18;3,084530336;0,324198465;63
driver;0,101385092;67;52;15;3,928054958;0,254578923;57
flat;0,100333755;25;20;5;4,532371105;0,220635066;30
miley;0,099845098;15;14;1;15,86329887;0,06303859;12
breast;0,098981568;24;18;6;3,399278329;0,294180089;25
cow;0,098850816;19;14;5;3,172659774;0,315192952;38
movement;0,098583787;10;8;2;4,532371105;0,220635066;9
dangerous;0,098417078;11;8;3;3,021580737;0,3309526;12
park;0,097872217;15;13;2;7,365103046;0,135775426;43
collection;0,097585313;16;14;2;7,931649434;0,126077181;16
troll;0,097020849;13;10;3;3,776975921;0,26476208;25
tri;0,095692438;13;9;4;2,549458747;0,392240118;175
michelle;0,095255502;27;23;4;6,515283464;0,153485264;26
object;0,094699909;48;35;13;3,050634398;0,32780067;64
skinny;0,094598166;14;12;2;6,798556658;0,147090044;14
bikini;0,094536991;23;15;8;2,124548956;0,470688142;20
tall;0,094380029;15;10;5;2,266185553;0,441270133;67
org;0,094266056;86;64;22;3,296269895;0,303373216;212
accord;0,093839482;15;11;4;3,116005135;0,320923733;16
surgery;0,093012846;19;14;5;3,172659774;0,315192952;17
lip;0,092393753;13;10;3;3,776975921;0,26476208;763
punch;0,092196292;28;21;7;3,399278329;0,294180089;30
road;0,091534488;11;9;2;5,098917494;0,196120059;17
versus;0,090659882;53;35;18;2,203235954;0,453877851;51
makeameme;0,090567414;52;40;12;3,776975921;0,26476208;52
halloween;0,089133806;22;16;6;3,021580737;0,3309526;21
emotional;0,089132014;10;7;3;2,643883145;0,378231542;17
treat;0,088339428;41;31;10;3,512587607;0,284690408;48
hit;0,088311034;82;62;20;3,512587607;0,284690408;403
queen;0,088225401;20;14;6;2,643883145;0,378231542;22
blind;0,087847656;11;7;4;1,982912359;0,504308723;13
commit;0,087462348;10;7;3;2,643883145;0,378231542;16
muslim;0,087074744;15;12;3;4,532371105;0,220635066;13
contain;0,086955565;10;8;2;4,532371105;0,220635066;12
manager;0,08690284;13;9;4;2,549458747;0,392240118;12
fault;0,086719715;17;12;5;2,719422663;0,367725111;17
tape;0,086120203;33;26;7;4,208630312;0,237606995;30
uber;0,085108938;10;7;3;2,643883145;0,378231542;14
military;0,084719528;16;11;5;2,492804108;0,401154666;15
agree;0,084042402;26;20;6;3,776975921;0,26476208;31
photo;0,083847601;75;55;20;3,116005135;0,320923733;101
horny;0,083772054;28;16;12;1,510790368;0,661905199;23
housewife;0,08265773;34;23;11;2,369193987;0,422084475;34
obviously;0,082656441;16;9;7;1,45683357;0,686420207;14
sexy;0,082598772;51;37;14;2,994602338;0,333934155;49
demand;0,081961566;13;9;4;2,549458747;0,392240118;11
hot;0,081170331;111;81;30;3,059350496;0,326866765;266
sal;0,080912919;21;13;8;1,841275762;0,543101702;94
wet;0,080375407;18;12;6;2,266185553;0,441270133;18
maker;0,08001912;38;32;6;6,043161474;0,1654763;40
shoe;0,079945395;14;11;3;4,154673513;0,2406928;15
humor;0,078975861;14;10;4;2,832731941;0,353016106;20
society;0,078940905;36;25;11;2,575210855;0,388317717;30
strong;0,078812878;64;42;22;2,163177118;0,462282996;64
excuse;0,078473316;39;28;11;2,884236158;0,346712247;40
complain;0,078238118;31;23;8;3,257641732;0,306970527;34
washing;0,077622707;18;13;5;2,946041219;0,339438564;40
challenge;0,077079115;23;16;7;2,589926346;0,386111366;24
bone;0,077041759;16;12;4;3,399278329;0,294180089;19
silence;0,07646849;18;12;6;2,266185553;0,441270133;16
oppress;0,075311602;21;15;6;2,832731941;0,353016106;28
judge;0,075137555;22;14;8;1,982912359;0,504308723;26
dish;0,074602053;37;24;13;2,091863587;0,478042644;180
beer;0,074551592;68;55;13;4,793854054;0,208600426;50
attention;0,074394726;34;23;11;2,369193987;0,422084475;32
useless;0,074147269;20;14;6;2,643883145;0,378231542;22
penis;0,073905979;28;18;10;2,039566997;0,490300148;27
tire;0,07389762;10;8;2;4,532371105;0,220635066;73
question;0,073808616;29;19;10;2,152876275;0,464494877;30
button;0,073229403;16;13;3;4,910068698;0,203663138;14
defend;0,073216834;10;6;4;1,699639165;0,588360177;9
plastic;0,073082044;30;20;10;2,266185553;0,441270133;28
sexual;0,0725933;37;27;10;3,059350496;0,326866765;65
camel;0,071859981;13;10;3;3,776975921;0,26476208;11
foot;0,071811038;24;19;5;4,30575255;0,232247438;32
dryer;0,071767491;13;8;5;1,812948442;0,551587666;11
curve;0,071497924;17;15;2;8,498195823;0,117672035;15
obama;0,071264178;31;24;7;3,884889519;0,257407578;32
hole;0,071170767;25;16;9;2,014387158;0,4964289;50
perfect;0,0711267;60;41;19;2,445094938;0,408982074;66
barbie;0,070667228;11;9;2;5,098917494;0,196120059;9
loyal;0,070129907;14;9;5;2,039566997;0,490300148;19
picture;0,069898746;109;66;43;1,739165657;0,574988355;93
suicide;0,069425761;19;16;3;6,043161474;0,1654763;11
teach;0,068937057;29;19;10;2,152876275;0,464494877;87
award;0,068476462;28;12;16;0,849819582;1,176720354;19
beauty;0,068153269;17;12;5;2,719422663;0,367725111;17
equal;0,067999297;95;87;8;12,32238394;0,081153128;125
apparently;0,067898723;13;10;3;3,776975921;0,26476208;13
memegenerator;0,067511307;177;154;23;7,586795111;0,131807962;177
violence;0,066725637;31;21;10;2,37949483;0,420257269;26
schumer;0,066545855;11;10;1;11,33092776;0,088254027;11
amy;0,066545855;11;10;1;11,33092776;0,088254027;23
rights;0,06613015;104;85;19;5,069099263;0,197273706;94
she;0,066074669;1902;1199;703;1,932543725;0,517452716;1430
crack;0,065669218;10;7;3;2,643883145;0,378231542;12
beat;0,065522131;84;56;28;2,266185553;0,441270133;80
www;0,065411483;97;65;32;2,301594702;0,434481362;112
pant;0,065016094;41;30;11;3,090253026;0,323598097;54
trigger;0,063788985;16;11;5;2,492804108;0,401154666;15
vote;0,063315703;36;23;13;2,004702604;0,498827107;55
coffee;0,06272061;25;18;7;2,913667139;0,343210103;22
assault;0,062571772;14;9;5;2,039566997;0,490300148;14
maybe;0,062463748;41;28;13;2,440507518;0,409750838;42
shop;0,062306609;16;9;7;1,45683357;0,686420207;38
backwards;0,062115864;13;8;5;1,812948442;0,551587666;13
cougar;0,061898878;76;48;28;1,942444759;0,514815155;71
radio;0,061177175;11;8;3;3,021580737;0,3309526;13
worth;0,060702073;30;21;9;2,643883145;0,378231542;43
cell;0,060678192;10;7;3;2,643883145;0,378231542;18
deserve;0,060442543;44;29;15;2,190646034;0,456486344;45
stare;0,059745153;32;20;12;1,888487961;0,529524159;38
cold;0,05918962;35;21;14;1,699639165;0,588360177;30
size;0,058550762;27;17;10;1,92625772;0,519141333;29
angry;0,058385715;41;27;14;2,185250354;0,457613471;37
report;0,058249123;16;10;6;1,888487961;0,529524159;21
nipple;0,058019394;36;19;17;1,266397809;0,78964129;29
choice;0,0574553;19;13;6;2,455034349;0,407326277;19
thur;0,057415789;13;8;5;1,812948442;0,551587666;20
meme;0,057271786;383;258;125;2,33870349;0,427587338;1345
face;0,05714045;137;89;48;2,100942856;0,475976773;186
couch;0,057133672;14;9;5;2,039566997;0,490300148;15
com;0,057026953;2387;1588;799;2,252004166;0,444048912;2780
cock;0,056683251;11;7;4;1,982912359;0,504308723;14
respect;0,056679446;49;31;18;1,951437559;0,512442735;55
billion;0,056384063;13;7;6;1,321941572;0,756463085;12
center;0,056110968;91;84;7;13,59711332;0,073545022;234
pig;0,056106088;27;18;9;2,266185553;0,441270133;40
date;0,054995035;110;67;43;1,765516652;0,566406439;127
sport;0,054841206;38;24;14;1,942444759;0,514815155;37
speak;0,054755368;42;25;17;1,666312906;0,600127381;41
shave;0,05443589;16;11;5;2,492804108;0,401154666;17
main;0,054435391;14;8;6;1,510790368;0,661905199;32
ability;0,054133125;11;8;3;3,021580737;0,3309526;17
winter;0,05397127;10;7;3;2,643883145;0,378231542;9
bury;0,053685529;10;7;3;2,643883145;0,378231542;11
abuse;0,053576534;29;18;11;1,854151816;0,539330162;30
yea;0,05292158;12;7;5;1,586329887;0,630385904;331
load;0,052657188;28;21;7;3,399278329;0,294180089;60
jessica;0,052069849;17;15;2;8,498195823;0,117672035;18
army;0,052061246;15;10;5;2,266185553;0,441270133;13
ride;0,05165322;19;12;7;1,942444759;0,514815155;34
artificial;0,051637548;14;12;2;6,798556658;0,147090044;5
parker;0,051606703;13;13;0;inf;0;13
marry;0,051441274;53;30;23;1,4779471;0,676614204;50
patriarchy;0,05101331;11;7;4;1,982912359;0,504308723;12
select;0,050128678;10;6;4;1,699639165;0,588360177;15
fuckin;0,049949783;14;7;7;1,133092776;0,882540266;117
public;0,049840329;30;19;11;1,95716025;0,510944364;46
cum;0,049787263;29;21;8;2,974368538;0,336205816;43
gift;0,049715272;12;8;4;2,266185553;0,441270133;13
stupid;0,04968293;49;30;19;1,789093857;0,558942168;52
pump;0,049532341;14;9;5;2,039566997;0,490300148;18
epic;0,049484953;29;23;6;4,343522309;0,230227895;33
eye;0,049256976;82;55;27;2,308151952;0,43324704;91
danger;0,04922637;11;7;4;1,982912359;0,504308723;23
national;0,049161451;19;12;7;1,942444759;0,514815155;44
lesson;0,049066839;10;6;4;1,699639165;0,588360177;10
cosplay;0,049029324;10;6;4;1,699639165;0,588360177;11
bit;0,04881006;33;19;14;1,537768768;0,650292827;245
contact;0,048742226;21;15;6;2,832731941;0,353016106;21
average;0,048565592;17;12;5;2,719422663;0,367725111;12
thomas;0,048499362;10;6;4;1,699639165;0,588360177;10
awesome;0,047794268;18;11;7;1,780574363;0,561616533;18
milf;0,047760623;136;81;55;1,668736634;0,599255736;127
divorce;0,047223851;30;20;10;2,266185553;0,441270133;26
model;0,046914474;19;11;8;1,558002567;0,641847466;21
admit;0,046645625;12;8;4;2,266185553;0,441270133;12
hungry;0,046175729;24;15;9;1,888487961;0,529524159;24
horse;0,046122812;20;13;7;2,104315156;0,475213989;20
man;0,045985651;940;575;365;1,785009168;0,560221212;2172
sin;0,045623726;15;10;5;2,266185553;0,441270133;221
lay;0,045509452;13;6;7;0,97122238;1,02963031;239
cute;0,045204235;48;29;19;1,729457395;0,578216036;53
legal;0,045113513;12;7;5;1,586329887;0,630385904;35
learn;0,04488246;52;31;21;1,672660765;0,597849857;58
wrong;0,044810349;84;54;30;2,039566997;0,490300148;79
themselves;0,044631483;24;14;10;1,586329887;0,630385904;22
fold;0,04455824;11;8;3;3,021580737;0,3309526;12
nut;0,044390439;17;10;7;1,618703966;0,617778186;116
trash;0,044225576;44;25;19;1,490911548;0,670730602;41
trust;0,04404457;30;18;12;1,699639165;0,588360177;28
victim;0,043863117;17;11;6;2,077336757;0,4813856;15
peace;0,043748463;10;6;4;1,699639165;0,588360177;16
sign;0,043745035;30;20;10;2,266185553;0,441270133;59
isn;0,043725191;60;36;24;1,699639165;0,588360177;73
abortion;0,043517879;15;11;4;3,116005135;0,320923733;11
science;0,043503288;21;13;8;1,841275762;0,543101702;20
soul;0,043447972;18;9;9;1,133092776;0,882540266;20
attractive;0,043352456;19;12;7;1,942444759;0,514815155;22
extreme;0,043335716;12;7;5;1,586329887;0,630385904;16
funny;0,043282666;113;70;43;1,844569636;0,542131878;155
round;0,043234295;11;6;5;1,359711332;0,735450221;28
tumblr;0,043230959;13;8;5;1,812948442;0,551587666;13
machine;0,043153893;33;20;13;1,743219656;0,573651173;30
spread;0,043037719;22;14;8;1,982912359;0,504308723;38
head;0,042866299;73;47;26;2,048283096;0,488213764;95
awkward;0,042684118;13;8;5;1,812948442;0,551587666;13
reverse;0,04264553;12;4;8;0,566546388;1,765080532;7
tear;0,042611698;17;11;6;2,077336757;0,4813856;17
ready;0,042610676;54;32;22;1,648134947;0,606746433;52
hide;0,04232609;21;14;7;2,266185553;0,441270133;21
dealer;0,042083197;12;8;4;2,266185553;0,441270133;12
poster;0,04206581;20;17;3;6,420859066;0,1557424;149
truck;0,041892583;27;16;11;1,648134947;0,606746433;25
starve;0,041431434;11;8;3;3,021580737;0,3309526;9
carpet;0,041430255;10;6;4;1,699639165;0,588360177;10
dry;0,040916739;13;7;6;1,321941572;0,756463085;49
industry;0,04034064;10;6;4;1,699639165;0,588360177;10
destroy;0,039948087;13;8;5;1,812948442;0,551587666;13
twice;0,039083605;12;9;3;3,399278329;0,294180089;13
prefer;0,038865503;15;9;6;1,699639165;0,588360177;14
accept;0,03886461;21;13;8;1,841275762;0,543101702;29
consent;0,038386786;12;8;4;2,266185553;0,441270133;10
available;0,038302268;10;8;2;4,532371105;0,220635066;11
ice;0,037915111;18;10;8;1,41636597;0,706032213;403
look;0,037528949;424;247;177;1,581208564;0,63242764;396
fix;0,037500763;51;32;19;1,908366781;0,524008283;47
dick;0,037471122;131;75;56;1,517534968;0,658963398;119
grab;0,037111524;21;12;9;1,510790368;0,661905199;22
dirty;0,037106008;25;15;10;1,699639165;0,588360177;26
alamy;0,037095226;15;9;6;1,699639165;0,588360177;7
pull;0,037048216;37;25;12;2,360609951;0,423619328;33
crash;0,036906418;19;10;9;1,258991974;0,794286239;18
generator;0,036651006;24;16;8;2,266185553;0,441270133;233
like;0,036586449;927;568;359;1,79274846;0,557802738;797
term;0,036084106;23;15;8;2,124548956;0,470688142;36
rise;0,035864;16;9;7;1,45683357;0,686420207;43
babe;0,035794911;28;15;13;1,307414742;0,76486823;25
bacon;0,035570441;21;10;11;1,030084342;0,970794292;16
false;0,035422524;16;10;6;1,888487961;0,529524159;18
butter;0,035381251;11;4;7;0,647481586;1,544445465;14
mother;0,035256796;65;38;27;1,594723167;0,627068084;77
apologize;0,03523406;14;9;5;2,039566997;0,490300148;13
small;0,035073429;48;30;18;1,888487961;0,529524159;45
support;0,034575502;58;33;25;1,495682465;0,66859111;55
finger;0,034208869;15;9;6;1,699639165;0,588360177;15
draft;0,034199782;14;11;3;4,154673513;0,2406928;14
celebrity;0,03400953;10;6;4;1,699639165;0,588360177;10
sentence;0,033885655;17;9;8;1,274729373;0,784480236;15
mama;0,033691294;23;13;10;1,473020609;0,678877128;24
chuck;0,033101159;11;7;4;1,982912359;0,504308723;15
standard;0,033042235;18;9;9;1,133092776;0,882540266;16
book;0,033038662;21;12;9;1,510790368;0,661905199;70
smart;0,032867568;27;16;11;1,648134947;0,606746433;33
damn;0,032857659;47;27;20;1,529675248;0,65373353;57
dreamstime;0,032716396;10;5;5;1,133092776;0,882540266;7
easy;0,032671742;32;18;14;1,45683357;0,686420207;32
kind;0,032404995;37;22;15;1,661869405;0,601731999;56
reply;0,032396249;79;48;31;1,754466234;0,569973922;58
rapist;0,032279529;27;13;14;1,052157578;0,950427979;24
protest;0,031729373;17;11;6;2,077336757;0,4813856;22
totally;0,031288757;13;9;4;2,549458747;0,392240118;16
delicious;0,031229258;15;8;7;1,294963173;0,772222733;14
hang;0,031110335;18;10;8;1,41636597;0,706032213;121
meat;0,030854919;27;14;13;1,220253759;0,819501675;30
pool;0,030747215;11;6;5;1,359711332;0,735450221;13
big;0,030364643;141;83;58;1,621494835;0,616714885;143
color;0,029874244;14;8;6;1,510790368;0,661905199;19
dude;0,02986161;36;20;16;1,41636597;0,706032213;33
sense;0,02967624;12;7;5;1,586329887;0,630385904;16
large;0,029396547;18;10;8;1,41636597;0,706032213;18
seat;0,029364524;10;5;5;1,133092776;0,882540266;15
bread;0,029307155;16;10;6;1,888487961;0,529524159;17
tired;0,029169471;26;15;11;1,545126513;0,647196195;26
half;0,02891335;59;35;24;1,652426966;0,605170468;51
slap;0,028617984;24;18;6;3,399278329;0,294180089;23
brand;0,028503202;11;7;4;1,982912359;0,504308723;18
flirt;0,028495332;15;9;6;1,699639165;0,588360177;11
suit;0,028380721;10;6;4;1,699639165;0,588360177;18
low;0,028305937;30;18;12;1,699639165;0,588360177;221
reason;0,028252807;53;31;22;1,59663073;0,626318898;54
tie;0,027899643;19;11;8;1,558002567;0,641847466;52
silent;0,02756763;13;8;5;1,812948442;0,551587666;13
left;0,02651703;39;26;13;2,266185553;0,441270133;44
fear;0,026507973;11;6;5;1,359711332;0,735450221;11
hair;0,02650099;52;29;23;1,428682196;0,699945728;75
streamer;0,026439347;11;7;4;1,982912359;0,504308723;9
burger;0,026235116;10;6;4;1,699639165;0,588360177;22
responsibility;0,02527805;15;11;4;3,116005135;0,320923733;11
fair;0,025189131;10;5;5;1,133092776;0,882540266;27
fact;0,025174186;39;23;16;1,628820866;0,613941054;52
ruin;0,025149065;18;10;8;1,41636597;0,706032213;19
follow;0,025046455;26;15;11;1,545126513;0,647196195;26
weight;0,024789391;22;12;10;1,359711332;0,735450221;26
welcome;0,024748893;20;12;8;1,699639165;0,588360177;20
limit;0,024647801;10;5;5;1,133092776;0,882540266;17
inferior;0,024199266;12;8;4;2,266185553;0,441270133;12
tag;0,023955935;20;11;9;1,384891171;0,722078399;104
light;0,023854683;30;17;13;1,481736708;0,674883733;60
cheap;0,023682658;16;9;7;1,45683357;0,686420207;17
chris;0,023616741;10;6;4;1,699639165;0,588360177;22
murder;0,023334771;17;9;8;1,274729373;0,784480236;17
mile;0,022843715;13;8;5;1,812948442;0,551587666;50
view;0,022789321;55;33;22;1,699639165;0,588360177;75
reality;0,022672816;32;18;14;1,45683357;0,686420207;32
birth;0,022502787;28;15;13;1,307414742;0,76486823;67
good;0,022253184;498;265;233;1,288710668;0,775969366;457
gag;0,022182918;97;52;45;1,309351653;0,763736768;120
mean;0,02217199;113;64;49;1,479957912;0,675694891;114
rest;0,022109067;15;9;6;1,699639165;0,588360177;106
cyrus;0,021437362;11;10;1;11,33092776;0,088254027;10
college;0,021246603;30;17;13;1,481736708;0,674883733;31
offend;0,021180473;20;12;8;1,699639165;0,588360177;22
accident;0,020854078;15;8;7;1,294963173;0,772222733;40
slave;0,020611152;13;7;6;1,321941572;0,756463085;20
brown;0,020424571;15;7;8;0,991456179;1,008617447;14
dollar;0,020255793;22;12;10;1,359711332;0,735450221;20
they;0,020229266;1227;663;564;1,331986721;0,750758235;896
sale;0,020208642;24;12;12;1,133092776;0,882540266;24
lot;0,02009249;69;41;28;1,659171565;0,602710425;144
real;0,020062883;136;71;65;1,237685956;0,807959398;379
ball;0,019859427;30;16;14;1,294963173;0,772222733;69
hooker;0,019760637;246;135;111;1,378085809;0,725644219;222
clothes;0,019747612;45;27;18;1,699639165;0,588360177;42
invent;0,019493167;16;9;7;1,45683357;0,686420207;25
busy;0,019463023;11;6;5;1,359711332;0,735450221;11
vegetable;0,019442215;13;7;6;1,321941572;0,756463085;11
theory;0,019019559;12;7;5;1,586329887;0,630385904;11
realise;0,018993011;20;11;9;1,384891171;0,722078399;20
masculinity;0,018933004;13;6;7;0,97122238;1,02963031;11
chill;0,018822379;12;7;5;1,586329887;0,630385904;20
want;0,018659065;458;245;213;1,303322677;0,7672697;421
act;0,018352129;35;19;16;1,345547672;0,743191803;422
control;0,0182218;28;17;11;1,751143382;0,571055466;28
floor;0,018196954;29;16;13;1,394575725;0,717063966;29
realize;0,018134472;57;31;26;1,350995233;0,740195062;55
gym;0,018129733;30;17;13;1,481736708;0,674883733;33
post;0,017820983;105;53;52;1,154883022;0,865888563;258
mame;0,017760287;18;10;8;1,41636597;0,706032213;21
spot;0,017699614;26;13;13;1,133092776;0,882540266;35
handle;0,017471964;17;9;8;1,274729373;0,784480236;19
god;0,017301489;100;50;50;1,133092776;0,882540266;108
amazing;0,01728437;16;9;7;1,45683357;0,686420207;17
iphone;0,017248447;18;10;8;1,41636597;0,706032213;18
scream;0,016923225;16;9;7;1,45683357;0,686420207;16
place;0,016610956;76;42;34;1,399702841;0,714437358;88
join;0,016584497;22;12;10;1,359711332;0,735450221;23
lick;0,016546783;13;7;6;1,321941572;0,756463085;24
shut;0,016201631;42;23;19;1,371638624;0,729055002;52
make;0,016128677;787;422;365;1,310041511;0,76333459;846
expectation;0,016099428;17;9;8;1,274729373;0,784480236;17
homeless;0,015978561;12;6;6;1,133092776;0,882540266;12
garbage;0,01568638;10;5;5;1,133092776;0,882540266;9
husband;0,015433103;98;52;46;1,280887486;0,780708697;86
mind;0,015369929;100;52;48;1,227517174;0,814652553;119
original;0,015251195;20;11;9;1,384891171;0,722078399;21
mistake;0,01524143;16;8;8;1,133092776;0,882540266;16
skin;0,015240134;13;8;5;1,812948442;0,551587666;33
dumb;0,015198232;34;17;17;1,133092776;0,882540266;33
car;0,01516549;116;63;53;1,346883866;0,742454509;365
check;0,015134721;36;19;17;1,266397809;0,78964129;44
thing;0,015133231;162;86;76;1,282183931;0,779919305;354
popular;0,014990885;11;6;5;1,359711332;0,735450221;13
actually;0,014885821;94;50;44;1,287605428;0,776635434;92
happy;0,014842969;96;49;47;1,18130949;0,846518214;86
brain;0,014639044;30;15;15;1,133092776;0,882540266;29
diet;0,014587264;18;10;8;1,41636597;0,706032213;15
its;0,014398592;104;60;44;1,545126513;0,647196195;111
argue;0,01413121;15;8;7;1,294963173;0,772222733;16
mad;0,014110662;30;17;13;1,481736708;0,674883733;57
kitchen;0,014031917;419;231;188;1,392257613;0,718257879;387
content;0,013866774;11;5;6;0,94424398;1,059048319;9
drug;0,013795075;36;20;16;1,41636597;0,706032213;33
hate;0,013625889;86;47;39;1,365522064;0,732320646;92
wanna;0,013575918;58;31;27;1,300958373;0,768664102;58
blowjob;0,013549045;19;9;10;1,019783499;0,980600295;17
nothing;0,013481379;68;35;33;1,201765066;0,832109393;66
wing;0,012567384;18;10;8;1,41636597;0,706032213;26
club;0,012458774;18;10;8;1,41636597;0,706032213;18
beautiful;0,012275558;55;29;26;1,263834251;0,791242997;54
lift;0,012261334;13;7;6;1,321941572;0,756463085;23
itself;0,012212338;13;7;6;1,321941572;0,756463085;13
ignore;0,011982291;22;10;12;0,94424398;1,059048319;17
guy;0,011778762;295;156;139;1,271672468;0,786366006;259
single;0,011752065;88;46;42;1,241006374;0,805797634;80
crazy;0,011680102;43;23;20;1,303056693;0,767426318;40
begin;0,011653994;21;10;11;1,030084342;0,970794292;27
card;0,011473787;19;10;9;1,258991974;0,794286239;32
right;0,011466066;192;103;89;1,311332089;0,762583336;303
daughter;0,011264932;53;26;27;1,091126377;0,916484122;50
lucky;0,011012277;13;8;5;1,812948442;0,551587666;12
yes;0,010381721;107;57;50;1,291725765;0,774158128;121
chance;0,010217601;28;15;13;1,307414742;0,76486823;28
honey;0,009549319;53;28;25;1,26906391;0,78798238;52
bag;0,009524648;25;12;13;1,045931794;0,956085288;55
repair;0,009286066;13;6;7;0,97122238;1,02963031;12
america;0,009078555;34;15;19;0,894546929;1,117884337;32
kick;0,008807404;21;11;10;1,246402054;0,802309333;23
huge;0,008798925;20;12;8;1,699639165;0,588360177;17
type;0,008393563;33;15;18;0,94424398;1,059048319;35
set;0,008131828;30;16;14;1,294963173;0,772222733;80
second;0,008129433;48;24;24;1,133092776;0,882540266;48
favorite;0,00805723;22;11;11;1,133092776;0,882540266;22
stand;0,008051264;36;17;19;1,013819853;0,986368532;110
voice;0,008047849;19;10;9;1,258991974;0,794286239;19
law;0,008000109;24;13;11;1,339109645;0,74676484;46
modern;0,0078231;35;16;19;0,954183391;1,048016566;31
shouldn;0,007676337;17;9;8;1,274729373;0,784480236;20
war;0,007357639;53;27;26;1,176673268;0,849853589;233
Sunday;0,007206716;19;10;9;1,258991974;0,794286239;19
fast;0,006795923;25;13;12;1,227517174;0,814652553;36
bad;0,006640264;134;70;64;1,239320224;0,806893957;138
job;0,006584544;114;60;54;1,258991974;0,794286239;123
misogyny;0,00635413;45;24;21;1,294963173;0,772222733;43
remove;0,006320314;25;13;12;1,227517174;0,814652553;24
dream;0,006300661;35;17;18;1,070143178;0,934454399;39
open;0,005502314;77;40;37;1,224965164;0,816349746;88
glass;0,005399436;15;9;6;1,699639165;0,588360177;33
cause;0,005359314;56;29;27;1,217025575;0,82167542;60
omg;0,005174405;31;16;15;1,208632295;0,827381499;33
way;0,004742193;103;52;51;1,155310282;0,865568338;176
course;0,004680801;24;13;11;1,339109645;0,74676484;26
dinner;0,003821366;54;29;25;1,314387621;0,760810574;49
care;0,002970451;71;36;35;1,165466856;0,858025258;125
hard;0,00293795;77;39;38;1,162911007;0,859911028;93
comment;0,002707048;66;29;37;0,888099744;1,125999649;55
boy;0,002682761;171;91;80;1,288893033;0,775859574;241
ass;0,001345784;138;68;70;1,100718697;0,908497332;401
saber;2,78E-17;19;19;0;inf;0;1
sound;2,49E-17;26;13;13;1,133092776;0,882540266;29
assume;2,30E-17;13;6;7;0,97122238;1,02963031;12
oven;2,22E-17;10;5;5;1,133092776;0,882540266;19
bible;2,22E-17;11;5;6;0,94424398;1,059048319;12
vacuum;2,09E-17;11;5;6;0,94424398;1,059048319;12
celebrate;2,07E-17;15;7;8;0,991456179;1,008617447;15
practice;1,97E-17;14;6;8;0,849819582;1,176720354;12
ape;1,91E-17;10;5;5;1,133092776;0,882540266;320
action;1,73E-17;12;6;6;1,133092776;0,882540266;39
professional;1,73E-17;12;6;6;1,133092776;0,882540266;13
fox;1,65E-17;30;16;14;1,294963173;0,772222733;23
tonight;1,57E-17;26;13;13;1,133092776;0,882540266;26
reddit;1,52E-17;16;8;8;1,133092776;0,882540266;24
double;1,52E-17;18;9;9;1,133092776;0,882540266;18
password;1,37E-17;10;6;4;1,699639165;0,588360177;8
bless;1,34E-17;10;5;5;1,133092776;0,882540266;10
language;1,21E-17;16;8;8;1,133092776;0,882540266;16
retweet;1,16E-17;12;6;6;1,133092776;0,882540266;13
heavy;1,15E-17;21;10;11;1,030084342;0,970794292;20
getty;1,11E-17;12;7;5;1,586329887;0,630385904;11
waste;1,11E-17;16;8;8;1,133092776;0,882540266;16
understand;1,05E-17;58;31;27;1,300958373;0,768664102;61
mommy;1,05E-17;18;6;12;0,566546388;1,765080532;12
page;9,64E-18;19;9;10;1,019783499;0,980600295;23
compare;9,41E-18;12;6;6;1,133092776;0,882540266;12
handsome;9,26E-18;12;6;6;1,133092776;0,882540266;12
message;8,41E-18;25;11;14;0,890287181;1,123233066;24
banana;6,99E-18;17;8;9;1,007193579;0,992857799;16
moment;6,93E-18;40;20;20;1,133092776;0,882540266;42
daily;6,33E-18;17;8;9;1,007193579;0,992857799;27
nigga;5,90E-18;10;5;5;1,133092776;0,882540266;12
stop;5,60E-18;165;82;83;1,119441056;0,893302952;163
shoulder;5,55E-18;12;6;6;1,133092776;0,882540266;10
quick;5,48E-18;12;6;6;1,133092776;0,882540266;287
touch;4,84E-18;47;22;25;0,997121643;1,002886666;48
nurse;4,62E-18;16;7;9;0,881294382;1,134694627;12
wine;3,01E-18;21;11;10;1,246402054;0,802309333;23
choose;2,49E-18;41;20;21;1,079135977;0,926667279;39
stuff;2,20E-18;42;20;22;1,030084342;0,970794292;38
product;8,76E-19;12;6;6;1,133092776;0,882540266;21
manspread;6,94E-19;14;6;8;0,849819582;1,176720354;15
need;5,69E-19;256;125;131;1,081195397;0,924902199;239
zee;0;10;0;10;0;inf;6
personality;-9,19E-21;26;12;14;0,97122238;1,02963031;24
skill;-5,53E-19;20;10;10;1,133092776;0,882540266;20
ounce;-5,78E-19;19;6;13;0,522965897;1,912170576;28
sue;-1,39E-18;11;5;6;0,94424398;1,059048319;38
settle;-1,39E-18;10;5;5;1,133092776;0,882540266;14
change;-1,48E-18;100;49;51;1,088657766;0,918562317;99
lol;-2,85E-18;35;17;18;1,070143178;0,934454399;69
juice;-3,47E-18;10;5;5;1,133092776;0,882540266;11
damage;-5,53E-18;10;5;5;1,133092776;0,882540266;10
proud;-6,08E-18;17;8;9;1,007193579;0,992857799;23
bar;-6,81E-18;32;16;16;1,133092776;0,882540266;88
snow;-6,94E-18;11;5;6;0,94424398;1,059048319;16
cunt;-7,31E-18;17;7;10;0,793164943;1,260771808;14
slowly;-8,00E-18;10;5;5;1,133092776;0,882540266;10
hero;-8,10E-18;12;6;6;1,133092776;0,882540266;24
google;-8,68E-18;50;21;29;0,820515459;1,218746081;39
stock;-8,98E-18;24;12;12;1,133092776;0,882540266;35
ford;-9,25E-18;18;3;15;0,226618555;4,412701329;24
politics;-1,04E-17;10;5;5;1,133092776;0,882540266;10
smell;-1,09E-17;39;19;20;1,076438138;0,928989753;38
princess;-1,11E-17;11;6;5;1,359711332;0,735450221;12
appear;-1,11E-17;10;5;5;1,133092776;0,882540266;18
bathroom;-1,41E-17;23;11;12;1,038668378;0,962771199;20
fail;-1,45E-17;18;9;9;1,133092776;0,882540266;32
shot;-1,50E-17;17;9;8;1,274729373;0,784480236;31
remind;-1,52E-17;19;10;9;1,258991974;0,794286239;21
till;-1,68E-17;17;6;11;0,618050605;1,617990487;14
tooth;-1,81E-17;15;7;8;0,991456179;1,008617447;17
naked;-2,30E-17;30;14;16;0,991456179;1,008617447;26
cos;-2,43E-17;11;7;4;1,982912359;0,504308723;53
printf;-2,78E-17;10;2;8;0,283273194;3,530161063;2
reject;-3,64E-17;12;6;6;1,133092776;0,882540266;12
ebony;-0,000114045;11;0;11;0;inf;7
cite;-0,000450122;25;0;25;0;inf;32
closet;-0,001409284;18;1;17;0,066652516;15,00318452;12
win;-0,001636517;147;74;73;1,148614595;0,870614046;255
free;-0,002118984;87;41;46;1,009930518;0,990167127;106
pay;-0,003319092;139;68;71;1,085215617;0,921475866;129
flu;-0,003530544;15;0;15;0;inf;37
female;-0,003924206;391;192;199;1,093235242;0,914716213;324
culture;-0,004207596;26;12;14;0,97122238;1,02963031;23
fake;-0,00490714;36;20;16;1,41636597;0,706032213;97
class;-0,005050591;43;20;23;0,985298066;1,014921306;58
joey;-0,005114456;11;1;10;0,113309278;8,825402658;3
door;-0,005179893;40;20;20;1,133092776;0,882540266;43
dump;-0,005183337;26;13;13;1,133092776;0,882540266;29
taste;-0,005242682;36;17;19;1,013819853;0,986368532;37
age;-0,005517262;63;33;30;1,246402054;0,802309333;464
rich;-0,005824305;33;15;18;0,94424398;1,059048319;38
afford;-0,005835435;14;6;8;0,849819582;1,176720354;13
million;-0,005869642;25;12;13;1,045931794;0,956085288;31
eagle;-0,005904722;10;2;8;0,283273194;3,530161063;6
say;-0,005951229;563;269;294;1,03674135;0,964560737;524
scientist;-0,006194831;26;13;13;1,133092776;0,882540266;23
zomby;-0,006325383;10;0;10;0;inf;9
important;-0,006401188;20;9;11;0,927075908;1,078660325;24
safe;-0,00678859;23;12;11;1,236101211;0,808995244;26
roast;-0,00691352;15;8;7;1,294963173;0,772222733;13
tree;-0,007024006;23;11;12;1,038668378;0,962771199;48
mario;-0,007031692;13;6;7;0,97122238;1,02963031;7
wtf;-0,007286416;30;15;15;1,133092776;0,882540266;29
fffffff;-0,007336724;14;1;13;0,087160983;11,47302346;9
guess;-0,007359944;52;25;27;1,049159978;0,953143487;53
gender;-0,007385344;96;47;49;1,086844092;0,920095171;102
hurt;-0,007564795;40;21;19;1,2523657;0,798488812;41
butt;-0,007585711;25;12;13;1,045931794;0,956085288;66
Canada;-0,007604191;11;5;6;0,94424398;1,059048319;11
fuck;-0,007662331;226;100;126;0,899279981;1,112000735;340
build;-0,007746167;22;11;11;1,133092776;0,882540266;32
piece;-0,007793239;26;12;14;0,97122238;1,02963031;26
serve;-0,007845253;20;10;10;1,133092776;0,882540266;74
let;-0,008029334;195;94;101;1,054561594;0,948261349;363
quote;-0,008059171;12;6;6;1,133092776;0,882540266;14
dear;-0,008237842;18;7;11;0,721059039;1,386848989;15
continue;-0,008247462;12;6;6;1,133092776;0,882540266;11
gram;-0,008785172;60;26;34;0,866482711;1,154091117;136
far;-0,00898929;24;12;12;1,133092776;0,882540266;68
just;-0,009117795;597;280;317;1,000839045;0,999161658;597
jerk;-0,009192796;10;4;6;0,755395184;1,323810399;12
mine;-0,009306001;20;9;11;0,927075908;1,078660325;46
window;-0,009413236;23;10;13;0,871609828;1,147302346;23
price;-0,00949335;18;7;11;0,721059039;1,386848989;15
tap;-0,009531297;17;9;8;1,274729373;0,784480236;57
oil;-0,009885496;16;7;9;0,881294382;1,134694627;103
business;-0,009922838;27;12;15;0,906474221;1,103175332;25
experience;-0,009947219;15;7;8;0,991456179;1,008617447;16
refuse;-0,009986075;20;7;13;0,61012688;1,639003351;17
knife;-0,010009544;18;9;9;1,133092776;0,882540266;17
group;-0,010370846;27;13;14;1,052157578;0,950427979;26
train;-0,010660207;12;5;7;0,809351983;1,235556372;24
comedy;-0,010838523;12;6;6;1,133092776;0,882540266;12
nice;-0,010906386;95;45;50;1,019783499;0,980600295;101
audience;-0,010960306;10;4;6;0,755395184;1,323810399;7
normal;-0,010967594;26;12;14;0,97122238;1,02963031;29
tiny;-0,011156582;14;6;8;0,849819582;1,176720354;13
blow;-0,011309657;17;9;8;1,274729373;0,784480236;34
advice;-0,01131308;13;6;7;0,97122238;1,02963031;12
sure;-0,011683924;70;33;37;1,01059626;0,989514843;98
career;-0,01172019;13;6;7;0,97122238;1,02963031;13
status;-0,01176212;10;5;5;1,133092776;0,882540266;9
know;-0,011814721;382;179;203;0,999131069;1,000869687;376
stone;-0,011928864;15;7;8;0,991456179;1,008617447;17
increase;-0,01194155;11;5;6;0,94424398;1,059048319;11
new;-0,01207911;235;105;130;0,915190319;1,0926689;294
mode;-0,012219073;12;4;8;0,566546388;1,765080532;69
fine;-0,012250395;28;13;15;0,98201374;1,018315691;34
feature;-0,012318188;13;6;7;0,97122238;1,02963031;12
facebook;-0,012685651;47;22;25;0,997121643;1,002886666;45
chad;-0,012729225;20;10;10;1,133092776;0,882540266;16
suppose;-0,012789197;28;14;14;1,133092776;0,882540266;26
pretty;-0,012840706;51;24;27;1,007193579;0,992857799;49
gonna;-0,012881521;97;42;55;0,865270847;1,155707491;95
world;-0,01292782;134;61;73;0,94683095;1,056154744;133
mar;-0,01301695;16;7;9;0,881294382;1,134694627;285
crap;-0,013121293;11;5;6;0,94424398;1,059048319;13
zone;-0,013130278;29;10;19;0,596364619;1,676826505;32
garden;-0,013213276;11;5;6;0,94424398;1,059048319;14
thank;-0,013244638;43;14;29;0,547010306;1,828119122;77
save;-0,013255703;73;33;40;0,93480154;1,069745777;66
grand;-0,013464688;15;4;11;0,412033737;2,426985731;48
map;-0,013726144;17;1;16;0,070818299;14,12064425;21
university;-0,01390517;14;7;7;1,133092776;0,882540266;11
wash;-0,01399192;54;22;32;0,779001284;1,283694932;215
design;-0,014099759;17;8;9;1,007193579;0,992857799;19
super;-0,014229049;18;9;9;1,133092776;0,882540266;46
uuuu;-0,014386283;38;1;37;0,030624129;32,65398983;14
street;-0,014425707;24;11;13;0,958770811;1,043002132;24
problem;-0,01443632;80;39;41;1,077819958;0,927798741;73
own;-0,014693733;96;43;53;0,919301686;1,087782188;233
away;-0,014826671;57;26;31;0,950335877;1,052259548;56
engineer;-0,014925063;14;7;7;1,133092776;0,882540266;21
solution;-0,014934712;19;9;10;1,019783499;0,980600295;17
daddy;-0,014962944;34;14;20;0,793164943;1,260771808;28
talk;-0,015117992;117;53;64;0,938342455;1,065709;115
value;-0,015187196;11;4;7;0,647481586;1,544445465;9
joke;-0,015187775;69;31;38;0,92436516;1,081823552;70
exit;-0,015654885;19;8;11;0,824067474;1,213492865;20
milk;-0,015710634;20;11;9;1,384891171;0,722078399;24
order;-0,015868322;40;19;21;1,025179179;0,975439241;56
phone;-0,015932507;61;29;32;1,026865329;0,973837535;77
avoid;-0,016019079;23;9;14;0,728416785;1,372840413;21
power;-0,0161038;39;18;21;0,97122238;1,02963031;60
exactly;-0,016176369;11;5;6;0,94424398;1,059048319;11
image;-0,016215273;40;19;21;1,025179179;0,975439241;41
starter;-0,016284909;11;5;6;0,94424398;1,059048319;16
twitter;-0,016351642;38;18;20;1,019783499;0,980600295;37
long;-0,016583849;100;43;57;0,854789287;1,169878957;124
throw;-0,016593476;24;11;13;0,958770811;1,043002132;26
expensive;-0,016688112;11;5;6;0,94424398;1,059048319;11
stick;-0,0167228;28;11;17;0,733177679;1,363925865;38
intelligent;-0,016934068;12;5;7;0,809351983;1,235556372;11
search;-0,017027155;24;10;14;0,809351983;1,235556372;29
ain;-0,017155747;33;21;12;1,982912359;0,504308723;377
famous;-0,017210204;10;4;6;0,755395184;1,323810399;9
position;-0,017319137;10;4;6;0,755395184;1,323810399;10
blame;-0,017414916;21;10;11;1,030084342;0,970794292;20
warning;-0,017529235;10;5;5;1,133092776;0,882540266;9
potato;-0,017697195;12;5;7;0,809351983;1,235556372;12
wedding;-0,018315463;16;6;10;0,679855666;1,470900443;14
point;-0,018332374;63;32;31;1,169644156;0,854960882;69
chicken;-0,018349864;33;14;19;0,834910467;1,197733218;29
drunk;-0,018405773;31;14;17;0,933135228;1,071656037;36
cake;-0,018454054;24;11;13;0,958770811;1,043002132;27
luck;-0,018494837;15;7;8;0,991456179;1,008617447;32
visit;-0,018634253;14;6;8;0,849819582;1,176720354;15
you;-0,018988229;5726;2464;3262;0,855898406;1,168362965;3395
something;-0,019010394;124;56;68;0,933135228;1,071656037;120
really;-0,019045176;141;60;81;0,839327982;1,191429359;132
matter;-0,019156748;42;19;23;0,936033163;1,068338216;41
iron;-0,019344273;18;9;9;1,133092776;0,882540266;38
gamer;-0,019655813;33;13;20;0,736510305;1,357754255;29
pokemon;-0,019661435;12;4;8;0,566546388;1,765080532;11
balcony;-0,019669081;14;2;12;0,188848796;5,295241595;14
sperm;-0,019839019;11;5;6;0,94424398;1,059048319;12
money;-0,019931011;114;49;65;0,854177631;1,170716679;99
quit;-0,020056792;21;10;11;1,030084342;0,970794292;42
bank;-0,020083901;16;6;10;0,679855666;1,470900443;17
sex;-0,020104511;198;84;114;0,834910467;1,197733218;351
speech;-0,02016492;11;5;6;0,94424398;1,059048319;13
expert;-0,020256728;15;6;9;0,755395184;1,323810399;16
escape;-0,020269832;22;11;11;1,133092776;0,882540266;21
cover;-0,020309994;25;11;14;0,890287181;1,123233066;60
listen;-0,020323076;50;22;28;0,890287181;1,123233066;49
news;-0,020330627;73;27;46;0,665076195;1,503587119;71
push;-0,02039005;22;10;12;0,94424398;1,059048319;22
germany;-0,020404082;14;5;9;0,629495987;1,588572478;12
warm;-0,020632375;11;5;6;0,94424398;1,059048319;20
instead;-0,020644241;66;29;37;0,888099744;1,125999649;64
internet;-0,020658894;32;14;18;0,881294382;1,134694627;31
network;-0,020682364;10;5;5;1,133092776;0,882540266;11
alcohol;-0,020739634;14;6;8;0,849819582;1,176720354;20
start;-0,02082456;197;81;116;0,791211335;1,263884825;210
believe;-0,020901593;48;22;26;0,958770811;1,043002132;47
forever;-0,021001626;18;8;10;0,906474221;1,103175332;19
cure;-0,021091486;14;5;9;0,629495987;1,588572478;15
speed;-0,02122968;16;5;11;0,515042171;1,941588585;17
dead;-0,021303114;56;25;31;0,913784497;1,09434993;64
decision;-0,021418036;11;5;6;0,94424398;1,059048319;10
teammate;-0,02156657;11;0;11;0;inf;5
unless;-0,021583189;10;4;6;0,755395184;1,323810399;10
mematic;-0,021651638;132;58;74;0,888099744;1,125999649;131
tell;-0,021665379;335;151;184;0,92987505;1,075413304;343
east;-0,021727249;10;3;7;0,48561119;2,05926062;55
credit;-0,021766777;10;4;6;0,755395184;1,323810399;9
smile;-0,021782687;25;11;14;0,890287181;1,123233066;25
team;-0,021878163;23;10;13;0,871609828;1,147302346;33
fry;-0,022085582;20;8;12;0,755395184;1,323810399;20
beast;-0,022090376;10;4;6;0,755395184;1,323810399;13
middle;-0,022190262;15;6;9;0,755395184;1,323810399;14
think;-0,022331984;380;164;216;0,860311182;1,162370106;348
male;-0,022577876;192;87;105;0,9388483;1,065134804;394
imgflip;-0,022814485;674;308;366;0,953531626;1,048732913;665
claim;-0,022884218;19;8;11;0,824067474;1,213492865;20
simple;-0,022965711;13;5;8;0,708182985;1,412064425;13
tweet;-0,022970173;12;4;8;0,566546388;1,765080532;23
tomorrow;-0,022994715;14;6;8;0,849819582;1,176720354;14
user;-0,023039028;15;7;8;0,991456179;1,008617447;16
vegan;-0,023194445;22;10;12;0,94424398;1,059048319;21
love;-0,023212878;250;102;148;0,780915292;1,280548621;257
jack;-0,023316993;11;5;6;0,94424398;1,059048319;28
cookie;-0,023471058;12;4;8;0,566546388;1,765080532;12
holy;-0,023627288;14;6;8;0,849819582;1,176720354;17
angel;-0,023808973;12;4;8;0,566546388;1,765080532;13
liquid;-0,023977225;13;4;9;0,503596789;1,985715598;9
block;-0,024170181;16;6;10;0,679855666;1,470900443;21
upgrade;-0,024275287;10;4;6;0,755395184;1,323810399;9
coin;-0,024302674;10;3;7;0,48561119;2,05926062;16
sell;-0,024410377;31;11;20;0,623201027;1,604618665;33
earn;-0,024429821;16;7;9;0,881294382;1,134694627;74
biden;-0,024526614;11;0;11;0;inf;8
paint;-0,024534912;10;3;7;0,48561119;2,05926062;14
drink;-0,024692242;68;28;40;0,793164943;1,260771808;66
pick;-0,024757094;57;23;34;0,766503937;1,304624741;60
mexico;-0,024850001;18;1;17;0,066652516;15,00318452;7
grade;-0,024931074;10;4;6;0,755395184;1,323810399;26
time;-0,025344;335;137;198;0,784008638;1,275496151;341
media;-0,025528576;29;11;18;0,692445586;1,444156799;38
promise;-0,025737421;13;4;9;0,503596789;1,985715598;13
complete;-0,025833125;16;7;9;0,881294382;1,134694627;29
come;-0,025865054;226;94;132;0,806899401;1,239311863;263
smoking;-0,025902793;18;4;14;0,323740793;3,08889093;15
able;-0,026080399;21;8;13;0,697287862;1,434127932;170
sorry;-0,026309468;86;37;49;0,855600668;1,168769541;76
account;-0,026691715;21;8;13;0,697287862;1,434127932;23
health;-0,026797203;12;4;8;0,566546388;1,765080532;36
twin;-0,026958563;12;6;6;1,133092776;0,882540266;14
true;-0,027047233;31;12;19;0,715637543;1,397355421;32
young;-0,02705697;41;19;22;0,978580125;1,021888729;41
kill;-0,02707415;121;48;73;0,745047305;1,342196654;141
salary;-0,027266254;13;4;9;0,503596789;1,985715598;13
afraid;-0,027325261;18;8;10;0,906474221;1,103175332;18
mosquito;-0,027329677;10;5;5;1,133092776;0,882540266;7
deal;-0,027330184;22;10;12;0,94424398;1,059048319;37
hold;-0,027330844;52;22;30;0,830934703;1,203463999;61
anymore;-0,027379002;25;11;14;0,890287181;1,123233066;25
help;-0,027685045;98;41;57;0,815031646;1,226946223;94
reduce;-0,027689836;11;4;7;0,647481586;1,544445465;11
hasn;-0,027706917;11;4;7;0,647481586;1,544445465;11
notice;-0,027991165;45;20;25;0,906474221;1,103175332;44
history;-0,028056589;38;16;22;0,824067474;1,213492865;40
squad;-0,028088607;10;3;7;0,48561119;2,05926062;9
past;-0,028223988;19;8;11;0,824067474;1,213492865;35
remember;-0,02828053;79;32;47;0,771467422;1,296231015;72
arrest;-0,028412127;22;7;15;0,528776629;1,891157712;17
thanks;-0,028523074;44;19;25;0,86115051;1,161237192;48
cost;-0,028695375;21;9;12;0,849819582;1,176720354;29
donkey;-0,02872715;11;5;6;0,94424398;1,059048319;9
kinda;-0,028778117;10;4;6;0,755395184;1,323810399;10
yell;-0,028923432;18;8;10;0,906474221;1,103175332;25
degree;-0,029023796;13;6;7;0,97122238;1,02963031;12
okay;-0,029094484;47;19;28;0,768884384;1,300585655;42
little;-0,029099315;127;56;71;0,893706979;1,11893498;111
bleach;-0,029157491;10;2;8;0,283273194;3,530161063;6
virgin;-0,029157971;61;27;34;0,899808969;1,111347001;72
area;-0,029161581;22;9;13;0,784448845;1,274780384;26
focus;-0,029191256;16;7;9;0,881294382;1,134694627;16
fucking;-0,029207723;104;55;49;1,271838831;0,786263146;104
ask;-0,029254245;220;92;128;0,814410433;1,227882109;243
run;-0,029271367;77;34;43;0,895933823;1,116153866;206
weird;-0,029316803;17;6;11;0,618050605;1,617990487;21
protect;-0,029517791;13;6;7;0,97122238;1,02963031;18
wit;-0,029676109;12;5;7;0,809351983;1,235556372;186
poor;-0,029707262;28;11;17;0,733177679;1,363925865;29
imgilip;-0,029738169;11;5;6;0,94424398;1,059048319;11
rule;-0,029935693;27;11;16;0,779001284;1,283694932;26
hey;-0,030148305;93;38;55;0,7828641;1,277360911;977
day;-0,030256866;330;139;191;0,824606785;1,212699214;534
comic;-0,03030213;18;7;11;0,721059039;1,386848989;26
tool;-0,030337014;10;4;6;0,755395184;1,323810399;11
jump;-0,030363622;10;4;6;0,755395184;1,323810399;10
try;-0,030428428;206;79;127;0,704837239;1,418767263;265
death;-0,030498284;42;17;25;0,770503088;1,297853332;43
bring;-0,030566914;56;22;34;0,733177679;1,363925865;55
read;-0,030643001;57;23;34;0,766503937;1,304624741;170
karen;-0,030725849;30;14;16;0,991456179;1,008617447;26
total;-0,030831568;14;6;8;0,849819582;1,176720354;28
blood;-0,030925543;17;6;11;0,618050605;1,617990487;23
nation;-0,030962651;14;6;8;0,849819582;1,176720354;69
hug;-0,030997489;19;8;11;0,824067474;1,213492865;40
yourself;-0,031037533;57;23;34;0,766503937;1,304624741;58
create;-0,03106974;54;21;33;0,721059039;1,386848989;51
miss;-0,031138385;48;21;27;0,881294382;1,134694627;76
send;-0,031316672;66;28;38;0,834910467;1,197733218;61
force;-0,031334907;45;19;26;0,828029337;1,207686679;51
result;-0,031387646;18;7;11;0,721059039;1,386848989;14
rare;-0,031394357;16;6;10;0,679855666;1,470900443;18
boyfriend;-0,031605756;70;28;42;0,755395184;1,323810399;65
share;-0,03164789;77;31;46;0,763606001;1,309575878;71
download;-0,031746132;23;9;14;0,728416785;1,372840413;26
base;-0,03181821;18;7;11;0,721059039;1,386848989;33
pass;-0,031821397;30;10;20;0,566546388;1,765080532;47
piss;-0,031865109;16;6;10;0,679855666;1,470900443;17
art;-0,031912823;57;30;27;1,258991974;0,794286239;514
today;-0,031973405;113;46;67;0,777944294;1,285439083;107
high;-0,032082945;67;27;40;0,764837624;1,30746706;74
red;-0,032187524;52;18;34;0,599872646;1,667020502;201
forget;-0,0323757;76;30;46;0,73897355;1,353228408;69
great;-0,032389591;114;44;70;0,712229745;1,404041332;103
release;-0,032442966;16;5;11;0,515042171;1,941588585;15
mate;-0,03267403;22;12;10;1,359711332;0,735450221;93
garage;-0,032674155;11;4;7;0,647481586;1,544445465;8
cut;-0,0326921;27;10;17;0,666525163;1,500318452;95
cup;-0,032742664;17;5;12;0,47212199;2,118096638;26
tip;-0,032912925;14;4;10;0,453237111;2,206350664;37
ring;-0,032938737;24;10;14;0,809351983;1,235556372;124
premium;-0,033015546;11;0;11;0;inf;9
fly;-0,03311677;21;9;12;0,849819582;1,176720354;20
sun;-0,033133843;16;6;10;0,679855666;1,470900443;39
dining;-0,033229887;14;0;14;0;inf;14
present;-0,033249744;15;6;9;0,755395184;1,323810399;21
wish;-0,033354226;22;9;13;0,784448845;1,274780384;26
infect;-0,033471189;18;0;18;0;inf;28
option;-0,033649358;15;6;9;0,755395184;1,323810399;15
shoot;-0,033834155;21;8;13;0,697287862;1,434127932;29
math;-0,033877755;18;6;12;0,566546388;1,765080532;24
future;-0,03388748;24;9;15;0,679855666;1,470900443;22
panic;-0,034019049;12;3;9;0,377697592;2,647620797;14
haha;-0,034027258;32;11;21;0,593524788;1,684849598;39
sister;-0,034092081;55;22;33;0,755395184;1,323810399;46
sort;-0,034145327;10;3;7;0,48561119;2,05926062;12
literally;-0,034223964;31;13;18;0,818344783;1,22197883;30
partner;-0,034291909;18;7;11;0,721059039;1,386848989;17
sad;-0,034299534;20;7;13;0,61012688;1,639003351;34
himself;-0,034405795;11;4;7;0,647481586;1,544445465;11
break;-0,034478891;120;42;78;0,61012688;1,639003351;141
easily;-0,034628893;12;5;7;0,809351983;1,235556372;12
bus;-0,034850054;11;3;8;0,424909791;2,353440709;103
turn;-0,034928137;89;35;54;0,734411985;1,361633553;120
word;-0,0350255;50;19;31;0,694476218;1,439934118;67
feed;-0,03504139;12;5;7;0,809351983;1,235556372;14
stay;-0,03511935;95;35;60;0,660970786;1,51292617;91
imagine;-0,035139492;32;15;17;0,999787744;1,000212301;30
bullshit;-0,035459195;19;8;11;0,824067474;1,213492865;19
mon;-0,03581609;12;4;8;0,566546388;1,765080532;316
promote;-0,035877288;13;5;8;0,708182985;1,412064425;13
leave;-0,036115397;205;72;133;0,613403608;1,630247991;198
use;-0,036172098;232;84;148;0,643106711;1,554951897;862
yesterday;-0,036223134;17;6;11;0,618050605;1,617990487;17
china;-0,036665806;39;4;35;0,129496317;7,722227326;34
enter;-0,037109087;22;5;17;0,333262581;3,000636904;267
reaction;-0,037195191;11;4;7;0,647481586;1,544445465;10
worker;-0,037306742;12;4;8;0,566546388;1,765080532;18
fight;-0,0373957;75;28;47;0,675033994;1,481406875;80
illegal;-0,037457948;16;7;9;0,881294382;1,134694627;16
idiot;-0,037499171;29;7;22;0,36052952;2,773697978;24
alive;-0,037513492;22;7;15;0,528776629;1,891157712;19
disease;-0,03777571;11;6;5;1,359711332;0,735450221;7
teenage;-0,037828338;13;4;9;0,503596789;1,985715598;16
weekend;-0,037865712;17;3;14;0,242805595;4,11852124;17
carry;-0,037875871;29;10;19;0,596364619;1,676826505;25
work;-0,037884822;274;98;176;0,63092666;1,584970273;304
lie;-0,038102048;43;16;27;0,671462386;1,489286699;143
office;-0,038126449;29;11;18;0,692445586;1,444156799;35
invite;-0,03822314;16;4;12;0,377697592;2,647620797;18
marvel;-0,03823742;16;7;9;0,881294382;1,134694627;14
online;-0,038390573;38;12;26;0,522965897;1,912170576;41
noise;-0,038420196;19;6;13;0,522965897;1,912170576;19
bang;-0,038436732;27;11;16;0,779001284;1,283694932;31
thousand;-0,038544967;16;7;9;0,881294382;1,134694627;15
disgusting;-0,038575474;16;6;10;0,679855666;1,470900443;15
update;-0,038610879;18;4;14;0,323740793;3,08889093;18
child;-0,038789078;94;41;53;0,876543468;1,140844734;98
cancer;-0,038889535;28;13;15;0,98201374;1,018315691;24
arm;-0,038949392;17;7;10;0,793164943;1,260771808;105
straight;-0,038996977;38;14;24;0,660970786;1,51292617;37
advantage;-0,039087603;11;5;6;0,94424398;1,059048319;10
chef;-0,039132419;21;8;13;0,697287862;1,434127932;20
german;-0,039409643;13;4;9;0,503596789;1,985715598;25
universe;-0,039587868;14;5;9;0,629495987;1,588572478;14
return;-0,039593032;34;11;23;0,541913937;1,845311465;34
march;-0,039636564;34;13;21;0,701438385;1,425641968;31
white;-0,039652766;163;59;104;0,642812248;1,555664197;148
draw;-0,039708248;21;8;13;0,697287862;1,434127932;22
repeat;-0,039719155;15;5;10;0,566546388;1,765080532;16
human;-0,039823303;48;18;30;0,679855666;1,470900443;52
didnt;-0,03982859;12;1;11;0,103008434;9,707942924;12
economy;-0,039842732;12;4;8;0,566546388;1,765080532;12
poop;-0,039911589;10;1;9;0,125899197;7,942862392;11
asshole;-0,040056021;14;5;9;0,629495987;1,588572478;12
pie;-0,040110873;12;5;7;0,809351983;1,235556372;51
programming;-0,04015568;10;3;7;0,48561119;2,05926062;8
prepare;-0,040281088;24;9;15;0,679855666;1,470900443;22
depression;-0,040456182;14;5;9;0,629495987;1,588572478;14
fridge;-0,040602293;18;5;13;0,435804914;2,294604691;16
pregnant;-0,040604075;46;20;26;0,871609828;1,147302346;43
probably;-0,040614877;45;18;27;0,755395184;1,323810399;42
heart;-0,040732388;33;13;20;0,736510305;1,357754255;34
morning;-0,040762517;32;13;19;0,775274005;1,289866542;32
dare;-0,040785395;14;5;9;0,629495987;1,588572478;15
meet;-0,040808246;94;37;57;0,735516364;1,359589058;98
toy;-0,040827913;13;5;8;0,708182985;1,412064425;14
screw;-0,040832664;17;4;13;0,348643931;2,868255864;12
lock;-0,040910488;17;4;13;0,348643931;2,868255864;88
suddenly;-0,040918065;17;6;11;0,618050605;1,617990487;17
lose;-0,040924068;124;49;75;0,740287281;1,350826937;175
race;-0,040941393;13;5;8;0,708182985;1,412064425;31
ban;-0,041057153;17;5;12;0,47212199;2,118096638;194
app;-0,04125176;21;9;12;0,849819582;1,176720354;319
childhood;-0,041276943;10;4;6;0,755395184;1,323810399;11
meal;-0,041295349;30;8;22;0,412033737;2,426985731;26
golden;-0,041349709;13;4;9;0,503596789;1,985715598;13
panik;-0,041374492;17;5;12;0,47212199;2,118096638;10
kalm;-0,041374492;13;4;9;0,503596789;1,985715598;10
couple;-0,041430637;22;8;14;0,647481586;1,544445465;22
italy;-0,041444135;17;1;16;0,070818299;14,12064425;16
wonder;-0,041547166;49;15;34;0,499893872;2,000424602;51
roll;-0,041571575;28;9;19;0,536728157;1,863140561;56
special;-0,04216049;22;5;17;0,333262581;3,000636904;30
cam;-0,042260165;25;3;22;0,154512651;6,471961949;60
decide;-0,042445927;28;9;19;0,536728157;1,863140561;29
hell;-0,042574168;57;21;36;0,660970786;1,51292617;120
wife;-0,042712321;518;195;323;0,684065298;1,461848748;485
figure;-0,042719429;17;5;12;0,47212199;2,118096638;17
turtle;-0,042735115;12;4;8;0,566546388;1,765080532;10
pain;-0,042822656;14;6;8;0,849819582;1,176720354;43
hour;-0,043060136;94;34;60;0,642085907;1,557423998;89
text;-0,043088654;36;10;26;0,435804914;2,294604691;41
trick;-0,043240666;12;4;8;0,566546388;1,765080532;19
jake;-0,043252616;10;4;6;0,755395184;1,323810399;10
hub;-0,043353244;18;4;14;0,323740793;3,08889093;47
black;-0,043365257;119;43;76;0,641091966;1,559838609;124
extra;-0,043633413;24;9;15;0,679855666;1,470900443;28
eat;-0,043761088;170;62;108;0,650479186;1,537328205;840
year;-0,043772327;276;91;185;0,557359149;1,794175266;248
knock;-0,043789887;10;3;7;0,48561119;2,05926062;12
masturbate;-0,043816468;18;7;11;0,721059039;1,386848989;15
shit;-0,043882768;141;56;85;0,746508182;1,339570046;177
land;-0,044069398;13;3;10;0,339927833;2,941800886;58
expect;-0,044081828;29;11;18;0,692445586;1,444156799;46
Chinese;-0,044126683;49;4;45;0,100719358;9,92857799;45
bernie;-0,044373091;17;8;9;1,007193579;0,992857799;11
fap;-0,044661917;22;11;11;1,133092776;0,882540266;11
pet;-0,044719185;15;6;9;0,755395184;1,323810399;81
consider;-0,044733535;23;9;14;0,728416785;1,372840413;27
mass;-0,045030237;11;4;7;0,647481586;1,544445465;30
freeze;-0,045047503;12;3;9;0,377697592;2,647620797;13
communist;-0,045103175;10;3;7;0,48561119;2,05926062;9
multiple;-0,0451047;13;5;8;0,708182985;1,412064425;10
computer;-0,045112409;27;12;15;0,906474221;1,103175332;26
toxic;-0,045156413;29;11;18;0,692445586;1,444156799;25
lead;-0,045406379;14;5;9;0,629495987;1,588572478;31
file;-0,04550913;11;4;7;0,647481586;1,544445465;23
pornhub;-0,045517064;20;3;17;0,199957549;5,001061506;19
spend;-0,045568234;45;16;29;0,625154635;1,599604232;43
hand;-0,045693776;102;29;73;0,450132747;2,221566876;125
hope;-0,045773383;37;14;23;0,689708646;1,44988758;42
end;-0,045853103;76;25;51;0,555437635;1,800382142;1160
crime;-0,045862439;18;6;12;0,566546388;1,765080532;19
sleep;-0,045870444;82;28;54;0,587529588;1,702041941;85
after;-0,046026555;347;125;222;0,638002689;1,567391512;327
conversation;-0,046103678;13;5;8;0,708182985;1,412064425;13
rage;-0,046185231;11;4;7;0,647481586;1,544445465;52
live;-0,046461148;116;38;78;0,552019558;1,811530019;150
family;-0,046464549;65;15;50;0,339927833;2,941800886;62
entire;-0,046469195;29;9;20;0,509891749;1,961200591;33
episode;-0,04647133;10;0;10;0;inf;10
introvert;-0,046534847;12;0;12;0;inf;13
dog;-0,046705402;73;26;47;0,626817281;1,59536125;83
rob;-0,046905409;10;2;8;0,283273194;3,530161063;155
hotel;-0,047355196;19;2;17;0,133305033;7,501592259;15
receive;-0,047490515;13;4;9;0,503596789;1,985715598;13
rate;-0,04752552;14;5;9;0,629495987;1,588572478;108
possible;-0,047867302;20;5;15;0,377697592;2,647620797;24
balance;-0,047870781;10;4;6;0,755395184;1,323810399;10
before;-0,048043544;124;47;77;0,691628058;1,44586384;119
play;-0,048300761;160;54;106;0,577235943;1,732393855;209
derp;-0,04831472;14;2;12;0,188848796;5,295241595;12
Asian;-0,048319063;28;10;18;0,629495987;1,588572478;27
pause;-0,048538778;12;0;12;0;inf;13
month;-0,048753896;74;25;49;0,578108559;1,729778921;69
ago;-0,048868183;74;24;50;0,543884533;1,838625554;100
agent;-0,048961396;13;3;10;0,339927833;2,941800886;13
privilege;-0,049004075;14;5;9;0,629495987;1,588572478;19
adult;-0,049097659;14;5;9;0,629495987;1,588572478;23
character;-0,049136182;56;23;33;0,789731329;1,266253425;49
bird;-0,04914684;17;6;11;0,618050605;1,617990487;16
worry;-0,049192894;26;9;17;0,599872646;1,667020502;26
form;-0,049242314;10;4;6;0,755395184;1,323810399;78
blue;-0,049338845;24;9;15;0,679855666;1,470900443;30
king;-0,049373735;26;6;20;0,339927833;2,941800886;276
shower;-0,049499699;22;7;15;0,528776629;1,891157712;20
fish;-0,049742613;25;7;18;0,440647191;2,269389255;32
prison;-0,049861637;13;5;8;0,708182985;1,412064425;14
honest;-0,049898641;13;4;9;0,503596789;1,985715598;18
pro;-0,049998708;16;5;11;0,515042171;1,941588585;695
leader;-0,050411649;11;4;7;0,647481586;1,544445465;15
Christmas;-0,050437103;22;6;16;0,424909791;2,353440709;20
star;-0,050487174;54;18;36;0,566546388;1,765080532;338
include;-0,050604079;12;3;9;0,377697592;2,647620797;10
French;-0,050785522;20;7;13;0,61012688;1,639003351;17
nose;-0,050972912;13;4;9;0,503596789;1,985715598;17
dating;-0,051005233;33;14;19;0,834910467;1,197733218;34
baby;-0,051035138;87;25;62;0,456892249;2,188699859;76
chocolate;-0,051052341;16;4;12;0,377697592;2,647620797;11
hire;-0,051074864;37;12;25;0,543884533;1,838625554;39
living;-0,051634991;29;6;23;0,29558942;3,383071019;28
song;-0,051672947;17;2;15;0,151079037;6,619051993;14
match;-0,051830715;19;6;13;0,522965897;1,912170576;19
magic;-0,051892392;37;5;32;0,177045746;5,648257701;45
gang;-0,05229715;23;5;18;0,314747993;3,177144957;16
steal;-0,052316496;34;10;24;0,47212199;2,118096638;34
positive;-0,052618743;20;3;17;0,199957549;5,001061506;16
minecraft;-0,052635961;10;2;8;0,283273194;3,530161063;10
scare;-0,052714558;13;4;9;0,503596789;1,985715598;20
shutterstock;-0,052786062;10;3;7;0,48561119;2,05926062;5
cheating;-0,052900086;25;8;17;0,53322013;1,875398065;23
source;-0,052934001;13;4;9;0,503596789;1,985715598;14
introduce;-0,052981702;12;4;8;0,566546388;1,765080532;12
non;-0,053172653;37;8;29;0,312577318;3,199208463;58
Japanese;-0,053225381;33;8;25;0,362589688;2,757938331;17
survive;-0,053236569;16;4;12;0,377697592;2,647620797;15
deep;-0,053284314;51;15;36;0,47212199;2,118096638;53
home;-0,053419512;188;57;131;0,493025101;2,028294295;200
pretend;-0,053469791;24;8;16;0,566546388;1,765080532;23
require;-0,053537306;16;6;10;0,679855666;1,470900443;19
city;-0,053807649;35;8;27;0,335731193;2,978573397;43
pack;-0,05380769;31;10;21;0,539567989;1,853334558;46
anal;-0,05409631;24;3;21;0,161870397;6,17778186;29
hello;-0,054133749;33;12;21;0,647481586;1,544445465;32
pee;-0,054277232;16;4;12;0,377697592;2,647620797;57
boss;-0,054281823;34;12;22;0,618050605;1,617990487;35
enjoy;-0,054345809;42;12;30;0,453237111;2,206350664;41
san;-0,054351443;16;3;13;0,261482948;3,824341152;254
essential;-0,054371579;13;3;10;0,339927833;2,941800886;14
walk;-0,05468283;75;24;51;0,53322013;1,875398065;84
cough;-0,054764404;24;4;20;0,226618555;4,412701329;25
sneeze;-0,054917299;10;2;8;0,283273194;3,530161063;6
write;-0,054932912;69;13;56;0,263039395;3,801711914;71
test;-0,05505922;52;9;43;0,237158953;4,21658127;81
travel;-0,055085686;23;5;18;0,314747993;3,177144957;26
porn;-0,055099806;62;20;42;0,539567989;1,853334558;77
dark;-0,055191812;21;5;16;0,354091493;2,824128851;22
loud;-0,055198194;16;6;10;0,679855666;1,470900443;24
binary;-0,055358696;10;2;8;0,283273194;3,530161063;10
absolutely;-0,055424711;12;4;8;0,566546388;1,765080532;12
chair;-0,055447329;31;11;20;0,623201027;1,604618665;19
lonely;-0,055569701;17;5;12;0,47212199;2,118096638;16
inside;-0,055708791;48;14;34;0,466567614;2,143312074;47
note;-0,055713311;14;4;10;0,453237111;2,206350664;16
kiss;-0,055829704;24;9;15;0,679855666;1,470900443;23
grow;-0,05599433;25;9;16;0,637364687;1,568960473;26
add;-0,056016261;15;5;10;0,566546388;1,765080532;72
press;-0,05605604;16;2;14;0,161870397;6,17778186;96
room;-0,056167875;94;25;69;0,410540861;2,435811134;146
jesus;-0,056256526;24;5;19;0,29818231;3,35365301;19
haunt;-0,056306376;14;1;13;0,087160983;11,47302346;13
error;-0,056333431;15;4;11;0,412033737;2,426985731;21
spell;-0,05648839;14;6;8;0,849819582;1,176720354;11
dad;-0,056518313;111;28;83;0,382248166;2,616101502;121
planet;-0,056553707;27;9;18;0,566546388;1,765080532;28
secret;-0,056689475;10;4;6;0,755395184;1,323810399;18
line;-0,056843456;22;6;16;0,424909791;2,353440709;113
box;-0,05684738;23;8;15;0,604316147;1,654762998;36
actual;-0,056951678;21;6;15;0,453237111;2,206350664;116
chat;-0,057403733;16;4;12;0,377697592;2,647620797;24
gucci;-0,057444278;14;1;13;0,087160983;11,47302346;4
state;-0,057467774;24;6;18;0,377697592;2,647620797;35
early;-0,057555493;34;10;24;0,47212199;2,118096638;44
bed;-0,05774457;51;15;36;0,47212199;2,118096638;98
provide;-0,057773987;12;5;7;0,809351983;1,235556372;12
cool;-0,058211986;22;7;15;0,528776629;1,891157712;26
folk;-0,058216005;14;0;14;0;inf;15
indian;-0,058307667;18;6;12;0,566546388;1,765080532;18
sanitize;-0,058702891;14;0;14;0;inf;17
bet;-0,058812257;24;9;15;0,679855666;1,470900443;59
life;-0,059035427;192;59;133;0,502650179;1,989455175;191
sheet;-0,059155085;12;1;11;0,103008434;9,707942924;12
cry;-0,05932236;35;9;26;0,392224423;2,549560768;45
bro;-0,059390364;38;12;26;0,522965897;1,912170576;141
laugh;-0,059698391;46;16;30;0,604316147;1,654762998;47
healthy;-0,059984862;18;5;13;0,435804914;2,294604691;20
wow;-0,06006514;32;11;21;0,593524788;1,684849598;32
buy;-0,060512753;87;21;66;0,36052952;2,773697978;87
dance;-0,060654844;10;3;7;0,48561119;2,05926062;13
mom;-0,06065929;214;65;149;0,494302218;2,02305384;245
toilet;-0,060722276;82;13;69;0,213481248;4,68425218;75
kid;-0,060905307;130;33;97;0,385485171;2,594133509;149
lion;-0,061062287;12;4;8;0,566546388;1,765080532;65
retard;-0,061423715;10;0;10;0;inf;11
catch;-0,061425629;40;13;27;0,545563189;1,832968244;41
late;-0,061446264;81;24;57;0,477091695;2,096033131;155
sir;-0,061471627;29;7;22;0,36052952;2,773697978;33
offer;-0,061759726;29;9;20;0,509891749;1,961200591;26
nude;-0,061785071;13;4;9;0,503596789;1,985715598;13
watch;-0,062148536;153;43;110;0,442936267;2,257661145;138
explain;-0,062168078;39;12;27;0,503596789;1,985715598;37
Christian;-0,062173656;13;3;10;0,339927833;2,941800886;12
random;-0,062395338;28;9;19;0,536728157;1,863140561;32
game;-0,062467981;192;50;142;0,39897633;2,506414355;191
yeah;-0,06255762;79;27;52;0,588336634;1,699707179;77
paper;-0,062887843;70;8;62;0,14620552;6,83968706;71
misogynist;-0,062915121;44;14;30;0,528776629;1,891157712;42
allow;-0,063163966;27;9;18;0,566546388;1,765080532;60
john;-0,063224923;13;3;10;0,339927833;2,941800886;24
finish;-0,063312832;28;10;18;0,629495987;1,588572478;28
trans;-0,063342228;29;17;12;1,605214766;0,622969599;58
bat;-0,063772245;22;3;19;0,178909386;5,589421683;139
cheese;-0,063847815;13;4;9;0,503596789;1,985715598;14
school;-0,063882769;85;22;63;0,395683192;2,527274397;86
son;-0,063883926;99;32;67;0,541178639;1,847818681;351
screen;-0,064110201;16;5;11;0,515042171;1,941588585;21
swim;-0,064215262;10;4;6;0,755395184;1,323810399;17
completely;-0,064258483;13;4;9;0,503596789;1,985715598;13
std;-0,06431743;10;3;7;0,48561119;2,05926062;134
die;-0,064522959;114;32;82;0,442182547;2,261509431;159
store;-0,064612701;17;5;12;0,47212199;2,118096638;21
friend;-0,064691071;256;81;175;0,524460085;1,906722796;706
country;-0,064883536;30;8;22;0,412033737;2,426985731;30
service;-0,065130948;14;4;10;0,453237111;2,206350664;14
role;-0,065203693;17;6;11;0,618050605;1,617990487;18
jail;-0,065307683;16;6;10;0,679855666;1,470900443;16
netflix;-0,065504597;32;6;26;0,261482948;3,824341152;25
space;-0,0658931;48;17;31;0,621373458;1,609338132;48
animal;-0,065937001;38;12;26;0,522965897;1,912170576;37
American;-0,065949193;38;11;27;0,46163039;2,166235198;35
number;-0,066058724;36;9;27;0,377697592;2,647620797;34
polish;-0,066059675;12;1;11;0,103008434;9,707942924;7
gear;-0,066085273;20;4;16;0,283273194;3,530161063;14
step;-0,066190557;29;11;18;0,692445586;1,444156799;39
brother;-0,066218644;37;7;30;0,264388314;3,782315425;39
truth;-0,066221442;11;2;9;0,251798395;3,971431196;12
video;-0,066306522;93;24;69;0,394119227;2,537303264;87
soon;-0,0663279;14;5;9;0,629495987;1,588572478;14
social;-0,066774778;46;13;33;0,446369882;2,240294521;59
fresh;-0,066869344;15;4;11;0,412033737;2,426985731;18
wall;-0,066888224;15;3;12;0,283273194;3,530161063;32
happen;-0,067041965;45;16;29;0,625154635;1,599604232;64
reach;-0,067279032;12;3;9;0,377697592;2,647620797;18
edgy;-0,067290395;13;6;7;0,97122238;1,02963031;7
bedroom;-0,067352361;54;10;44;0,257521086;3,883177169;43
party;-0,067416052;39;9;30;0,339927833;2,941800886;36
father;-0,067550425;33;10;23;0,492649033;2,029842611;42
player;-0,06756537;26;10;16;0,708182985;1,412064425;26
method;-0,067828452;10;4;6;0,755395184;1,323810399;9
seriously;-0,068631477;12;4;8;0,566546388;1,765080532;13
old;-0,068671247;171;49;122;0,45509464;2,197345152;398
police;-0,068723636;29;10;19;0,596364619;1,676826505;28
week;-0,068783478;55;11;44;0,283273194;3,530161063;76
project;-0,068848552;14;3;11;0,309025303;3,235980975;12
finally;-0,069030573;99;31;68;0,516557001;1,935894777;98
shield;-0,069205091;10;1;9;0,125899197;7,942862392;10
feeling;-0,069467499;23;7;16;0,49572809;2,017234893;21
raise;-0,069682904;25;10;15;0,755395184;1,323810399;25
table;-0,069861537;23;7;16;0,49572809;2,017234893;67
hmm;-0,069953306;19;5;14;0,404675992;2,471112744;19
virus;-0,070110919;82;7;75;0,105755326;9,455788562;164
cyberpunk;-0,070173985;14;3;11;0,309025303;3,235980975;13
night;-0,070593644;74;17;57;0,337939951;2,959105597;118
lego;-0,070734607;12;3;9;0,377697592;2,647620797;11
hear;-0,070870451;100;31;69;0,509070668;1,964363817;131
sea;-0,070883491;15;3;12;0,283273194;3,530161063;96
burn;-0,071008269;34;9;25;0,407913399;2,451500738;37
movie;-0,071292177;54;15;39;0,435804914;2,294604691;51
sjw;-0,071400739;17;3;14;0,242805595;4,11852124;10
drop;-0,071492849;27;9;18;0,566546388;1,765080532;29
sit;-0,07176916;56;17;39;0,493912236;2,024651198;166
charge;-0,071995298;19;6;13;0,522965897;1,912170576;22
sick;-0,072209093;32;9;23;0,44338413;2,255380679;30
government;-0,072248087;39;7;32;0,247864045;4,034469786;38
virginity;-0,072454778;15;4;11;0,412033737;2,426985731;15
study;-0,072579898;38;14;24;0,660970786;1,51292617;31
warzone;-0,072684759;13;1;12;0,094424398;10,59048319;10
smoke;-0,072838434;11;2;9;0,251798395;3,971431196;14
exist;-0,072885115;43;13;30;0,49100687;2,036631383;80
weed;-0,07313027;11;3;8;0,424909791;2,353440709;11
lord;-0,073196978;21;8;13;0,697287862;1,434127932;26
answer;-0,073285411;30;9;21;0,48561119;2,05926062;29
ramsay;-0,073360619;20;3;17;0,199957549;5,001061506;17
condom;-0,073382825;14;5;9;0,629495987;1,588572478;14
grind;-0,073506195;11;2;9;0,251798395;3,971431196;11
bear;-0,073679783;46;12;34;0,399915098;2,500530753;54
pandemic;-0,073692662;16;2;14;0,161870397;6,17778186;16
minute;-0,074005996;92;29;63;0,521582389;1,917242646;80
japan;-0,074009676;22;8;14;0,647481586;1,544445465;18
soap;-0,074261342;14;0;14;0;inf;12
discover;-0,074373003;23;8;15;0,604316147;1,654762998;23
feel;-0,074457348;117;36;81;0,503596789;1,985715598;130
soup;-0,074746716;15;2;13;0,174321966;5,736511728;15
bath;-0,074778238;30;3;27;0,125899197;7,942862392;42
officer;-0,075114899;10;3;7;0,48561119;2,05926062;9
egg;-0,075478642;29;8;21;0,431654391;2,316668198;31
surprise;-0,075486502;22;7;15;0,528776629;1,891157712;23
lack;-0,07599998;13;4;9;0,503596789;1,985715598;139
code;-0,076005197;68;7;61;0,13002704;7,69070803;63
different;-0,076109071;36;6;30;0,226618555;4,412701329;38
convince;-0,076852857;18;3;15;0,226618555;4,412701329;18
sugar;-0,07692884;13;3;10;0,339927833;2,941800886;12
corona;-0,07704764;73;4;69;0,065686538;15,22381958;161
level;-0,077271139;29;8;21;0,431654391;2,316668198;26
teen;-0,077547887;21;6;15;0,453237111;2,206350664;44
board;-0,077601612;16;4;12;0,377697592;2,647620797;27
member;-0,077740639;14;2;12;0,188848796;5,295241595;88
idea;-0,078199398;50;14;36;0,440647191;2,269389255;54
usa;-0,078434731;34;11;23;0,541913937;1,845311465;59
massive;-0,078501261;16;4;12;0,377697592;2,647620797;13
lockdown;-0,078565949;28;1;27;0,041966399;23,82858718;29
fall;-0,078588572;23;4;19;0,238545848;4,192066262;29
mobile;-0,078656338;10;1;9;0,125899197;7,942862392;9
prostitute;-0,078737558;213;65;148;0,497642098;2,009476297;201
fool;-0,079038913;18;5;13;0,435804914;2,294604691;20
self;-0,079116348;24;7;17;0,466567614;2,143312074;161
manage;-0,079144136;15;1;14;0,080935198;12,35556372;28
owner;-0,079184411;25;6;19;0,357818771;2,794710842;25
doctor;-0,079243155;63;16;47;0,385733711;2,592462031;51
gordon;-0,079306339;21;3;18;0,188848796;5,295241595;18
season;-0,079412348;14;4;10;0,453237111;2,206350664;15
fetish;-0,079816614;11;3;8;0,424909791;2,353440709;11
green;-0,07989478;10;4;6;0,755395184;1,323810399;11
donate;-0,079904092;16;3;13;0,261482948;3,824341152;12
liberal;-0,079941585;27;7;20;0,396582472;2,521543617;30
hentai;-0,079978308;28;4;24;0,188848796;5,295241595;16
access;-0,080156744;13;2;11;0,206016868;4,853971462;13
youtube;-0,080276925;20;3;17;0,199957549;5,001061506;19
somebody;-0,080415099;18;5;13;0,435804914;2,294604691;16
failure;-0,080565651;11;1;10;0,113309278;8,825402658;11
dev;-0,08069968;14;5;9;0,629495987;1,588572478;47
demon;-0,080926146;18;4;14;0,323740793;3,08889093;24
sink;-0,081029587;22;7;15;0,528776629;1,891157712;22
weeb;-0,08148203;12;5;7;0,809351983;1,235556372;7
people;-0,08180922;318;73;245;0,337615399;2,961950207;281
trump;-0,081902865;81;19;62;0,347238109;2,879868236;67
case;-0,081987497;23;4;19;0,238545848;4,192066262;24
amber;-0,082206608;12;3;9;0,377697592;2,647620797;12
food;-0,082220629;112;28;84;0,377697592;2,647620797;99
attack;-0,082233529;31;9;22;0,463537954;2,15732065;30
tax;-0,082554257;12;3;9;0,377697592;2,647620797;19
master;-0,082948587;16;3;13;0,261482948;3,824341152;28
close;-0,083075235;44;14;30;0,528776629;1,891157712;56
beard;-0,083152303;10;3;7;0,48561119;2,05926062;15
coronavirus;-0,083219647;106;10;96;0,118030498;8,472386552;94
teacher;-0,083452353;66;20;46;0,492649033;2,029842611;58
exam;-0,083476655;14;0;14;0;inf;20
earth;-0,083489338;28;6;22;0,309025303;3,235980975;29
haven;-0,083577418;31;7;24;0,330485393;3,02585234;34
apple;-0,084065921;14;2;12;0,188848796;5,295241595;10
company;-0,084364178;26;1;25;0,045323711;22,06350664;23
florida;-0,084445335;11;4;7;0,647481586;1,544445465;10
myself;-0,084452048;35;8;27;0,335731193;2,978573397;33
restaurant;-0,084467717;18;4;14;0,323740793;3,08889093;18
rose;-0,084704071;17;5;12;0,47212199;2,118096638;26
story;-0,085290752;34;10;24;0,47212199;2,118096638;71
boomer;-0,086378488;16;3;13;0,261482948;3,824341152;14
air;-0,08690581;40;12;28;0,48561119;2,05926062;203
fan;-0,087002596;23;4;19;0,238545848;4,192066262;54
cook;-0,087064466;176;45;131;0,389230343;2,569172774;263
bite;-0,087130613;20;4;16;0,283273194;3,530161063;15
basic;-0,087258314;12;4;8;0,566546388;1,765080532;18
shame;-0,087429927;15;4;11;0,412033737;2,426985731;18
racist;-0,087844054;40;7;33;0,240353013;4,160546967;35
everybody;-0,08788486;14;4;10;0,453237111;2,206350664;14
Satan;-0,088076948;10;2;8;0,283273194;3,530161063;10
programmer;-0,088372597;19;1;18;0,062949599;15,88572478;18
wait;-0,08889544;108;30;78;0,435804914;2,294604691;120
reveal;-0,088938229;16;2;14;0,161870397;6,17778186;9
legend;-0,089294806;15;3;12;0,283273194;3,530161063;19
neighbor;-0,089456689;12;2;10;0,226618555;4,412701329;14
ghost;-0,089567078;16;1;15;0,075539518;13,23810399;16
cop;-0,089936271;23;6;17;0,399915098;2,500530753;52
india;-0,090476245;19;3;16;0,212454896;4,706881418;36
asleep;-0,090591653;10;2;8;0,283273194;3,530161063;10
wake;-0,090959365;36;7;29;0,273505153;3,656238244;43
sing;-0,090994125;16;3;13;0,261482948;3,824341152;127
bob;-0,091631431;20;3;17;0,199957549;5,001061506;20
birthday;-0,092124172;40;13;27;0,545563189;1,832968244;39
snack;-0,092775757;17;5;12;0,47212199;2,118096638;16
bottle;-0,093342433;18;5;13;0,435804914;2,294604691;18
captain;-0,093530027;25;5;20;0,283273194;3,530161063;20
dolphin;-0,09371106;10;2;8;0,283273194;3,530161063;12
climate;-0,093971535;15;2;13;0,174321966;5,736511728;14
wood;-0,094053556;13;4;9;0,503596789;1,985715598;27
clean;-0,09416371;290;59;231;0,289404649;3,455369515;274
enemy;-0,094692804;18;0;18;0;inf;17
russia;-0,094798138;16;3;13;0,261482948;3,824341152;16
quarantine;-0,095264112;111;14;97;0,163539164;6,11474327;107
relationship;-0,095930561;97;25;72;0,393434992;2,541715965;92
evil;-0,096470808;15;3;12;0,283273194;3,530161063;22
british;-0,096659311;11;2;9;0,251798395;3,971431196;11
gta;-0,096808781;19;2;17;0,133305033;7,501592259;19
couldn;-0,096834345;19;4;15;0,302158074;3,309525997;19
mission;-0,097002854;10;3;7;0,48561119;2,05926062;16
list;-0,097048896;10;3;7;0,48561119;2,05926062;93
copy;-0,097076808;11;1;10;0,113309278;8,825402658;13
doc;-0,097294927;10;3;7;0,48561119;2,05926062;64
memeful;-0,097541761;169;43;126;0,386690392;2,586048221;169
house;-0,098080896;382;39;343;0,128835622;7,761828491;421
tom;-0,098755841;14;2;12;0,188848796;5,295241595;79
girlfriend;-0,098919858;492;129;363;0,402669334;2,48342726;437
plan;-0,099347747;30;2;28;0,080935198;12,35556372;84
harry;-0,100347446;14;2;12;0,188848796;5,295241595;9
pizza;-0,10054587;26;5;21;0,269783994;3,706669116;24
cheat;-0,100546089;262;50;212;0,267238862;3,741970727;239
Democrat;-0,100654711;23;3;20;0,169963916;5,883601772;21
outside;-0,100982079;30;10;20;0,566546388;1,765080532;27
anime;-0,101129233;25;6;19;0,357818771;2,794710842;23
april;-0,101200873;30;6;24;0,283273194;3,530161063;25
simp;-0,101406222;13;4;9;0,503596789;1,985715598;38
student;-0,102167279;23;5;18;0,314747993;3,177144957;20
water;-0,102330397;57;8;49;0,184994739;5,405559128;56
profile;-0,102840616;10;3;7;0,48561119;2,05926062;10
score;-0,102935393;12;3;9;0,377697592;2,647620797;12
monster;-0,10315107;10;1;9;0,125899197;7,942862392;11
tiger;-0,1040904;21;4;17;0,266610065;3,75079613;15
aunt;-0,104306761;10;1;9;0,125899197;7,942862392;26
parent;-0,104541721;58;2;56;0,040467599;24,71112744;74
version;-0,105238492;11;3;8;0,424909791;2,353440709;11
gun;-0,105399165;31;8;23;0,394119227;2,537303264;38
rock;-0,105473596;25;5;20;0,283273194;3,530161063;32
witcher;-0,105662901;21;0;21;0;inf;18
squirt;-0,105739339;18;5;13;0,435804914;2,294604691;21
lesbian;-0,105868956;26;3;23;0,14779471;6,766142038;17
pan;-0,106876247;13;1;12;0,094424398;10,59048319;205
washington;-0,107153454;14;2;12;0,188848796;5,295241595;15
covid;-0,107265129;80;15;65;0,261482948;3,824341152;74
cooking;-0,108113884;90;16;74;0,244993033;4,081748729;81
music;-0,108156323;24;2;22;0,103008434;9,707942924;26
housewive;-0,10828351;19;5;14;0,404675992;2,471112744;18
accidentally;-0,108390612;22;5;17;0,333262581;3,000636904;22
stranger;-0,10863718;13;4;9;0,503596789;1,985715598;7
donald;-0,109183265;13;2;11;0,206016868;4,853971462;26
alright;-0,11017387;16;5;11;0,515042171;1,941588585;15
york;-0,110832198;13;1;12;0,094424398;10,59048319;12
crush;-0,111658346;28;6;22;0,309025303;3,235980975;26
goal;-0,11181719;18;2;16;0,141636597;7,060322126;18
recipe;-0,112461849;21;4;17;0,266610065;3,75079613;19
person;-0,112727911;47;11;36;0,346222793;2,888313597;80
market;-0,113855697;16;4;12;0,377697592;2,647620797;17
bond;-0,115324533;12;3;9;0,377697592;2,647620797;13
nightmare;-0,115948083;13;1;12;0,094424398;10,59048319;11
aid;-0,117138223;11;2;9;0,251798395;3,971431196;56
grandma;-0,117302955;17;0;17;0;inf;14
duty;-0,1174825;34;6;28;0,242805595;4,11852124;33
league;-0,118380772;12;1;11;0,103008434;9,707942924;14
python;-0,118415555;10;1;9;0,125899197;7,942862392;9
hunt;-0,118821535;14;3;11;0,309025303;3,235980975;19
mess;-0,119002715;13;3;10;0,339927833;2,941800886;43
racism;-0,119193975;10;3;7;0,48561119;2,05926062;10
farm;-0,119328413;10;3;7;0,48561119;2,05926062;15
mum;-0,120197195;26;2;24;0,094424398;10,59048319;35
channel;-0,121920621;10;2;8;0,283273194;3,530161063;10
clear;-0,122597459;11;2;9;0,251798395;3,971431196;25
witch;-0,122821295;107;8;99;0,091563053;10,92143579;124
regular;-0,122917153;13;1;12;0,094424398;10,59048319;11
orgasm;-0,12353791;16;4;12;0,377697592;2,647620797;13
employee;-0,123695293;11;3;8;0,424909791;2,353440709;11
datum;-0,123950863;15;2;13;0,174321966;5,736511728;14
president;-0,124244467;46;11;35;0,356114873;2,808082664;42
tinder;-0,124377951;23;5;18;0,314747993;3,177144957;21
raw;-0,125994713;10;3;7;0,48561119;2,05926062;40
gold;-0,127174244;135;13;122;0,120739394;8,282300956;126
purpose;-0,12732551;10;1;9;0,125899197;7,942862392;11
snake;-0,130063038;13;4;9;0,503596789;1,985715598;12
depressed;-0,132868419;11;2;9;0,251798395;3,971431196;11
fluid;-0,135708496;11;1;10;0,113309278;8,825402658;8
quite;-0,136841973;11;2;9;0,251798395;3,971431196;11
upvote;-0,138065798;13;3;10;0,339927833;2,941800886;12
sauce;-0,138551722;14;3;11;0,309025303;3,235980975;12
deliver;-0,139306932;12;2;10;0,226618555;4,412701329;15
gay;-0,14093334;61;7;54;0,146882397;6,808167765;65
dragon;-0,141376758;16;1;15;0,075539518;13,23810399;17
fart;-0,144055326;20;3;17;0,199957549;5,001061506;17
mouse;-0,145212082;10;1;9;0,125899197;7,942862392;8
fbi;-0,146686383;15;2;13;0,174321966;5,736511728;12
church;-0,149257417;19;5;14;0,404675992;2,471112744;20
gagger;-0,149360541;14;2;12;0,188848796;5,295241595;13
pound;-0,149946642;19;2;17;0,133305033;7,501592259;9
motherfucker;-0,154661312;10;1;9;0,125899197;7,942862392;10
cat;-0,154679809;78;9;69;0,14779471;6,766142038;205
identify;-0,155880657;19;3;16;0,212454896;4,706881418;17
Thailand;-0,155942131;12;3;9;0,377697592;2,647620797;12
cousin;-0,15634117;10;1;9;0,125899197;7,942862392;9
battle;-0,156443611;12;2;10;0,226618555;4,412701329;20
energy;-0,15911075;12;2;10;0,226618555;4,412701329;12
zero;-0,160811777;20;3;17;0,199957549;5,001061506;19
blackjack;-0,162166745;13;0;13;0;inf;10
bug;-0,175748401;32;3;29;0,117216494;8,531222569;22
zipmeme;-0,177576349;32;3;29;0,117216494;8,531222569;32
memecrunch;-0,185544258;74;18;56;0,364208392;2,745680827;74
weak;-0,187174312;14;2;12;0,188848796;5,295241595;16
communism;-0,198676092;11;1;10;0,113309278;8,825402658;10
valentine;-0,207122531;13;2;11;0,206016868;4,853971462;13
anti;-0,212382905;30;3;27;0,125899197;7,942862392;166
template;-0,215026806;10;1;9;0,125899197;7,942862392;11
developer;-0,219449508;12;0;12;0;inf;11
ambulance;-0,239497028;35;1;34;0,033326258;30,00636904;30
mcdonald;-0,28857352;12;1;11;0,103008434;9,707942924;12
memeshappen;-0,303216922;15;1;14;0,080935198;12,35556372;16
